"socDep","socDep2","polDep1","polDep2","ecDep","sd1","sd2","pd1","pd2","pd3","pd4","ec1","ec2","teaparty","trump","third_party","pid7","age","college","female","own_home","married","wt"
1,1,2,3,0,4,3,8,6,9,6,6,6,1,1,1,1,27,1,1,0,0,1.31005864043466
1,1,-2,4,0,4,3,5,7,4,0,5,5,4,1,3,4,22,0,1,1,0,0.822444774980676
0,1,-1,1,-5,2,2,5,6,3,2,5,10,3,3,1,4,35,0,0,0,1,0.684910294649593
-1,0,1,-3,1,2,3,5,4,3,6,7,6,3,4,4,2,59,1,0,1,1,0.985472751540992
0,1,0,-2,-2,3,3,3,3,2,4,8,10,1,1,2,2,45,1,1,1,1,0.969829421803896
0,0,-1,2,-2,3,3,7,8,7,5,3,5,4,4,3,7,55,0,1,1,1,0.771329385970023
-2,0,-2,-1,4,1,3,4,6,1,2,6,2,3,1,3,3,18,0,1,0,0,1.46005202260656
-1,-1,-2,-3,-3,2,3,5,7,2,5,2,5,4,4,4,7,45,0,0,1,0,0.832673599097802
0,0,2,3,0,3,3,7,5,8,5,8,8,1,1,2,1,63,1,1,1,1,0.851411619082983
0,0,1,0,1,3,3,5,4,7,7,4,3,2,2,3,3,25,1,0,1,0,1.36527798203521
0,-1,1,-1,2,3,3,6,5,4,5,7,5,3,3,2,6,33,1,1,0,1,0.951245140882692
-1,-2,-4,-2,-4,3,4,5,9,6,8,4,8,2,5,2,1,38,0,0,0,0,0.865188204160568
2,2,-4,-4,-3,3,1,1,5,0,4,6,9,1,4,4,3,70,1,0,1,1,0.806290359845386
-1,-1,-4,-4,-4,3,4,2,6,1,5,1,5,1,1,1,3,28,0,1,0,0,1.08460247676401
0,0,-3,-2,-1,3,3,2,5,2,4,6,7,1,1,1,3,47,1,1,1,0,1.18571536547696
0,0,0,0,0,1,1,0,0,0,0,1,1,3,3,1,4,76,1,1,1,0,1.30067979544374
-2,-1,-1,-1,0,2,4,7,8,5,6,6,6,3,1,2,1,72,1,0,1,0,1.03817088521266
0,0,-2,0,0,3,3,2,4,5,5,3,3,3,3,1,4,51,0,1,1,0,1.31079890102165
0,-1,-1,1,0,4,4,5,6,6,5,5,5,3,4,3,5,66,0,0,1,0,0.808769537078292
3,0,-6,-1,-8,4,1,2,8,7,8,0,8,1,1,1,1,39,0,1,0,0,1.02517828825512
0,0,1,0,1,3,3,3,2,3,3,3,2,1,2,3,1,46,1,0,0,1,1.02864532845628
0,0,0,1,0,4,4,10,10,10,9,10,10,5,4,4,1,35,0,0,1,1,0.717899331727471
-1,1,2,-1,3,2,3,6,4,3,4,7,4,2,4,1,1,42,0,1,0,0,1.20587761041072
0,-1,1,-1,1,3,3,7,6,7,8,7,6,4,4,3,7,28,0,0,1,1,1.0448951733737
-1,1,-1,-1,-2,1,2,2,3,1,2,2,4,3,5,4,7,22,1,1,0,0,1.08459788563781
1,2,0,-1,1,3,2,9,9,8,9,9,8,5,5,3,1,53,1,1,1,1,1.25505699243484
0,0,0,0,-3,4,4,10,10,0,0,2,5,3,5,4,6,34,0,0,1,0,1.42951433657525
1,1,-1,0,0,3,2,7,8,4,4,7,7,1,1,1,1,57,1,1,1,1,0.718009250408674
0,0,-1,-2,-4,3,3,7,8,1,3,3,7,4,5,3,7,59,0,0,0,0,0.541328259223347
-1,0,-2,-1,-1,2,3,5,7,4,5,5,6,3,1,2,4,20,0,1,0,0,0.891431184016287
0,0,0,0,-3,4,4,3,3,2,2,2,5,3,1,3,2,54,1,1,1,1,0.902754346370359
0,0,0,0,1,3,3,7,7,7,7,7,6,3,5,4,5,33,0,0,1,0,0.75825828068281
0,0,0,0,-2,1,1,2,2,0,0,3,5,3,1,1,4,20,0,0,0,0,1.10872372223138
1,1,-3,-2,0,3,2,3,6,3,5,3,3,3,1,2,1,36,0,0,1,1,0.635767432543875
0,-1,-6,-3,2,3,3,2,8,2,5,5,3,3,5,3,6,54,0,1,1,1,0.886895624068659
0,0,-1,-1,-1,2,2,3,4,1,2,5,6,2,2,3,5,53,1,0,1,0,0.885007200601137
0,-1,-6,-6,-7,3,3,2,8,0,6,1,8,2,4,4,6,50,0,0,0,1,0.832673599097802
1,1,1,0,-1,3,2,1,0,2,2,3,4,1,1,1,3,52,1,1,0,0,1.30164870743789
-1,-1,-3,2,-3,2,3,3,6,5,3,2,5,4,5,4,7,65,0,0,0,0,0.671085328484537
0,0,-2,-2,5,3,3,0,2,0,2,5,0,2,1,1,4,43,1,0,1,1,0.847725474530199
1,1,1,2,0,3,2,6,5,5,3,3,3,1,1,1,1,21,0,1,0,0,0.938074257573367
2,1,1,1,0,4,2,6,5,6,5,7,7,2,4,2,7,78,0,1,1,1,0.764262111353379
0,0,-4,-3,-2,3,3,2,6,2,5,6,8,1,1,4,1,44,1,1,1,0,1.21703537278988
-1,-1,-3,-3,2,3,4,7,10,3,6,9,7,4,5,3,7,73,1,0,1,1,0.736992402444187
0,-1,0,0,-2,4,4,6,6,4,4,5,7,1,1,1,2,65,1,0,1,1,0.701950457688055
-1,0,1,1,2,3,4,7,6,8,7,8,6,4,1,3,7,68,1,0,1,0,1.13466982537596
0,-3,0,0,0,4,4,10,10,10,10,10,10,5,2,4,1,30,1,0,1,1,1.07031718476409
-1,0,-3,-1,-1,2,3,3,6,2,3,3,4,3,3,4,2,27,1,1,1,1,1.231007060359
-1,0,0,1,1,3,4,7,7,7,6,7,6,4,3,3,2,34,1,0,1,1,1.23979183686474
0,0,0,0,0,4,4,8,8,8,8,8,8,5,5,4,7,36,1,0,1,0,0.949784303043851
0,0,0,1,-6,1,1,0,0,2,1,1,7,2,1,1,1,55,1,1,1,1,0.74754625868897
0,3,0,0,0,1,1,0,0,0,0,0,0,1,1,3,2,45,1,1,1,0,0.917649122025639
0,0,1,0,-3,2,2,3,2,1,1,2,5,1,1,1,3,49,1,0,0,0,1.38019511141068
1,2,-1,-2,-1,3,2,8,9,7,9,7,8,1,4,3,7,45,1,0,1,1,0.744108942899536
-1,-1,0,0,0,3,4,5,5,5,5,5,5,2,1,2,1,22,1,1,1,0,0.979679996295024
1,2,-2,-3,0,2,1,2,4,1,4,6,6,1,1,1,2,44,1,1,1,0,0.829897244885358
-1,0,-2,0,0,2,3,3,5,2,2,9,9,1,2,2,2,68,1,1,1,1,1.25997978451697
1,1,0,-5,1,4,3,2,2,2,7,7,6,2,1,3,4,62,1,1,1,1,1.37486016079663
-2,-1,-9,-7,-2,1,3,0,9,0,7,0,2,2,1,2,2,20,0,1,0,0,0.827049991678052
-1,-2,0,1,1,2,3,0,0,3,2,5,4,3,1,3,2,27,1,1,0,0,0.902911405143792
1,1,-3,-2,2,3,2,1,4,1,3,5,3,5,5,4,6,60,0,0,1,0,0.684132925579315
-1,-1,0,0,3,2,3,4,4,1,1,8,5,3,1,1,4,33,1,0,0,0,1.19547964201569
0,-1,0,0,0,3,3,2,2,2,2,4,4,2,4,3,7,68,1,0,1,1,1.08040064352854
0,0,-4,-4,-1,2,2,1,5,1,5,4,5,4,4,3,4,56,0,1,1,1,0.836520027953328
0,1,0,0,1,2,2,1,1,1,1,1,0,2,1,3,3,51,0,1,0,0,0.768883845169354
0,0,-2,-2,-2,2,2,4,6,6,8,3,5,1,1,1,1,73,0,1,1,0,1.04314200355664
-1,-1,-2,3,-3,2,3,2,4,4,1,3,6,4,4,3,6,49,0,0,0,1,1.05090776007454
0,0,0,0,1,2,2,6,6,4,4,6,5,3,4,3,5,31,1,0,0,0,0.875442055209413
0,0,0,0,1,1,1,9,9,9,9,7,6,1,4,3,1,71,1,1,1,1,1.18395006359059
1,1,0,0,2,4,3,4,4,8,8,9,7,1,1,1,1,87,1,1,0,0,1.43893931536135
-1,0,-3,-5,-3,2,3,4,7,2,7,2,5,3,5,4,4,56,0,0,1,0,0.673007600884199
0,-1,-1,0,0,3,3,2,3,3,3,5,5,3,3,2,4,21,1,1,0,1,0.94959099365949
-1,0,1,0,0,3,4,5,4,7,7,5,5,4,1,3,2,43,1,0,1,1,1.40468754804547
0,0,0,-1,0,4,4,6,6,5,6,6,6,5,5,4,1,32,1,1,1,1,1.4834951538334
-2,-2,-2,0,-2,1,3,0,2,0,0,3,5,4,1,4,6,29,0,1,1,1,0.802967033197015
0,0,-5,-4,2,2,2,0,5,1,5,8,6,1,1,3,3,29,1,1,1,1,1.24149235409135
-1,-1,-1,2,-1,2,3,5,6,7,5,5,6,1,1,2,2,55,1,1,1,1,1.24275764350747
2,2,-2,-3,-2,4,2,8,10,5,8,5,7,3,2,4,7,65,0,1,0,0,1.09563675475129
1,1,2,2,-3,3,2,7,5,5,3,2,5,1,1,1,1,18,0,0,0,0,0.878639570960826
-3,-3,-8,-8,-2,1,4,0,8,0,8,5,7,4,4,3,4,53,0,1,1,1,0.758741486595744
-2,-2,-1,-1,0,1,3,1,2,1,2,3,3,1,1,1,1,52,1,1,1,0,1.30164870743789
-1,-1,0,0,-2,1,2,3,3,1,1,1,3,3,2,2,4,67,0,1,0,0,0.777221842105169
1,0,-4,-4,0,2,1,0,4,0,4,0,0,4,1,4,7,49,0,1,0,0,1.00730305735456
0,0,-1,0,1,3,3,5,6,5,5,5,4,3,1,3,3,56,0,1,1,0,0.909681516050907
0,0,-3,-5,-1,3,3,6,9,2,7,3,4,5,4,4,7,49,0,1,1,1,1.05720606642475
0,0,-2,-3,-3,2,2,1,3,1,4,2,5,2,3,2,2,43,0,0,0,0,1.01831159076451
1,2,-4,0,0,3,2,3,7,3,3,5,5,3,5,4,6,62,0,1,1,1,1.03417449158577
-1,0,0,0,3,2,3,3,3,4,4,8,5,4,4,2,4,41,0,1,1,1,1.15279184168449
0,0,-4,-6,1,3,3,2,6,0,6,8,7,1,1,1,2,62,1,0,0,1,1.26529992434598
0,-1,1,1,0,4,4,8,7,8,7,8,8,4,5,3,1,42,1,1,1,1,1.53931777234212
0,0,-5,-3,1,3,3,3,8,3,6,7,6,2,1,2,1,64,0,1,1,1,1.16798759949302
-1,-1,0,0,-5,1,2,7,7,0,0,0,5,3,4,3,5,52,0,1,0,1,0.840509038434814
1,2,-1,0,2,3,2,1,2,5,5,8,6,4,5,4,7,63,1,1,1,1,1.09626853833801
-1,1,-1,-1,2,2,3,8,9,7,8,9,7,4,1,3,1,31,1,0,1,1,1.35374722985557
-2,0,-5,-7,-3,1,3,0,5,0,7,3,6,4,5,4,7,54,0,1,1,1,0.628934501007348
-1,0,1,0,-4,2,3,4,3,7,7,3,7,4,1,3,2,57,1,1,1,1,1.09233198870541
0,-1,0,1,-1,3,3,5,5,5,4,5,6,4,4,3,4,50,1,1,1,1,1.10591995401979
2,2,-1,-3,-6,4,2,5,6,7,10,3,9,4,5,4,5,33,0,0,0,1,0.617930498889213
0,0,0,1,1,2,2,5,5,6,5,7,6,1,2,1,1,67,1,1,1,0,0.83291415213072
-1,-1,-3,-2,-1,3,4,7,10,8,10,6,7,4,1,2,3,28,0,1,1,1,0.887192119663341
0,-1,-6,-3,-2,4,4,3,9,4,7,3,5,4,4,3,4,30,0,1,0,1,1.02515984705531
0,1,0,-2,0,2,2,2,2,2,4,5,5,3,1,3,6,70,0,0,1,1,1.13799658958841
0,0,-2,-2,3,2,2,0,2,1,3,10,7,1,1,2,1,75,1,1,1,1,1.4267864403679
0,0,0,0,-1,2,2,5,5,1,1,7,8,2,1,3,2,30,1,1,1,1,1.34095451603201
-1,1,2,0,-1,1,2,4,2,1,1,5,6,4,4,3,7,58,0,1,1,1,1.03417449158577
0,-1,1,2,1,2,2,8,7,9,7,9,8,4,4,2,1,35,1,0,1,0,0.757313627500052
1,0,-4,0,-1,2,1,3,7,2,2,2,3,4,1,3,5,21,0,1,0,1,0.923761592646631
2,2,-5,-8,0,4,2,4,9,2,10,5,5,3,3,3,7,41,1,1,0,0,1.35935499541098
0,0,0,0,0,2,2,0,0,0,0,0,0,3,3,1,4,53,0,1,1,1,1.18485166695204
-1,-1,-3,-4,-3,2,3,3,6,1,5,1,4,2,4,4,1,55,0,1,0,0,1.03839991469962
2,2,3,3,2,4,2,8,5,6,3,8,6,4,4,3,2,66,0,0,1,0,0.976775438457927
0,0,0,-1,0,3,3,1,1,1,2,3,3,3,1,2,2,43,0,1,1,0,1.20587761041072
1,0,-3,1,-3,3,2,2,5,3,2,3,6,4,4,4,7,55,1,1,0,1,0.749185553999051
1,3,-7,-6,-8,2,1,1,8,1,7,0,8,5,5,4,5,50,0,0,0,0,1.16261703924884
-2,-2,-3,-6,-8,1,3,5,8,0,6,1,9,1,3,1,4,52,0,1,1,0,0.665784408216724
-1,-1,-3,-4,0,3,4,5,8,3,7,5,5,5,2,3,7,58,1,1,1,1,0.829724719810971
0,0,-1,-1,-3,4,4,8,9,8,9,7,10,5,5,3,4,31,1,1,1,1,1.34095451603201
1,1,-1,0,1,3,2,8,9,9,9,9,8,1,1,4,1,69,1,1,1,0,1.12806439225518
0,0,0,0,0,3,3,0,0,5,5,5,5,4,5,4,4,76,1,1,1,0,0.745602505963222
2,2,2,3,3,3,1,2,0,3,0,4,1,4,2,4,1,69,0,1,1,0,0.800461268964008
0,0,0,0,0,2,2,5,5,5,5,5,5,3,1,3,7,43,0,1,1,1,1.14506222126633
-1,-1,-7,-1,4,3,4,2,9,8,9,7,3,2,5,3,6,73,0,1,1,1,0.633413132439133
0,0,0,0,0,4,4,5,5,5,5,5,5,2,2,3,4,56,0,1,0,1,0.812520488638325
0,0,-2,-2,0,3,3,2,4,3,5,6,6,3,2,3,2,51,1,1,0,1,1.33565298699237
1,-1,-1,0,-1,4,3,7,8,7,7,7,8,4,4,4,7,27,1,0,0,0,0.875442055209413
-1,0,0,0,0,2,3,5,5,5,5,5,5,2,2,3,4,34,1,0,1,1,1.06334018021065
0,-1,-1,1,0,3,3,6,7,6,5,5,5,2,5,3,5,36,0,0,1,0,0.635767432543875
-1,-1,-3,-1,-2,2,3,3,6,6,7,2,4,1,1,2,2,57,1,1,0,0,0.937534564967132
0,1,2,0,-1,2,2,6,4,5,5,7,8,1,1,1,2,22,0,1,0,0,0.717270317205514
-1,-1,-1,0,2,1,2,2,3,0,0,3,1,3,1,3,4,53,0,0,1,0,0.624682053750765
0,0,0,0,0,1,1,0,0,0,0,0,0,3,1,1,1,58,0,0,0,0,0.643228357273556
-2,-2,-7,-8,-5,2,4,1,8,1,9,3,8,5,1,4,7,35,0,1,1,1,1.02517828825512
1,1,0,2,-6,2,1,5,5,3,1,1,7,1,2,1,1,58,0,0,0,0,0.941226800581441
-1,-1,-1,-1,-1,2,3,4,5,3,4,3,4,1,1,1,1,63,0,1,1,1,1.16798759949302
0,0,-2,-1,-2,1,1,1,3,0,1,1,3,1,1,1,2,44,0,0,0,0,0.865188204160568
0,0,1,-1,1,4,4,7,6,8,9,8,7,3,5,3,7,36,1,0,1,0,1.11059227951854
0,0,-4,0,0,2,2,1,5,4,4,0,0,4,2,3,5,61,1,1,1,1,0.914201458118039
0,0,-1,-1,-1,3,3,6,7,6,7,8,9,4,2,2,5,66,1,1,1,1,1.4267864403679
0,0,1,1,-3,3,3,8,7,8,7,6,9,4,4,3,1,38,1,0,1,1,1.40468754804547
0,0,0,1,1,3,3,7,7,8,7,7,6,3,4,3,7,31,1,0,0,0,1.00893399229496
-1,-2,-7,-5,-1,2,3,0,7,0,5,3,4,4,5,4,6,59,0,1,1,0,0.901103940095466
-1,-1,0,0,3,1,2,1,1,2,2,6,3,2,2,4,6,24,1,1,0,1,1.10422484379656
-2,-2,-1,-2,-3,2,4,4,5,2,4,6,9,1,1,3,1,66,0,1,1,0,0.726059563304626
-1,-1,-3,-3,-8,2,3,0,3,0,3,0,8,4,1,1,4,51,0,0,0,1,0.905498681072959
0,0,-9,-4,0,4,4,1,10,6,10,10,10,1,1,1,1,65,1,1,1,0,1.46084211438129
0,0,0,0,-1,2,2,4,4,5,5,7,8,1,2,1,1,65,1,0,1,1,1.0896031237261
-2,-2,-6,-3,1,1,3,0,6,1,4,6,5,1,1,2,2,80,0,0,1,0,0.596329323822318
0,-2,-6,-7,-1,4,4,3,9,2,9,5,6,2,2,3,4,71,1,1,1,1,1.11124574671694
1,1,-1,1,0,2,1,6,7,4,3,4,4,3,1,2,3,28,1,0,0,1,0.900162595983666
1,0,-2,0,0,3,2,2,4,2,2,3,3,2,2,4,6,65,0,1,1,1,0.971271510085113
0,0,-1,-1,-2,2,2,5,6,7,8,5,7,2,4,3,4,69,1,0,0,0,0.648207590440935
1,1,-2,3,-2,3,2,1,3,3,0,4,6,4,1,1,5,33,0,0,1,0,1.15005149062081
0,0,-3,-2,-6,3,3,2,5,1,3,1,7,2,4,4,2,47,0,1,1,0,1.11793668662274
-3,-1,0,0,1,1,4,7,7,7,7,9,8,1,3,1,1,85,1,0,0,1,0.704105564659269
0,2,0,0,0,2,2,9,9,9,9,9,9,1,1,3,1,39,1,0,0,1,1.20357125003959
-1,-1,-4,-4,-4,2,3,2,6,3,7,4,8,4,4,3,7,41,0,0,0,0,1.07449306690113
0,0,-2,-5,-5,3,3,0,2,0,5,0,5,3,3,3,2,50,0,1,1,1,1.12808240178319
-3,-3,-6,-6,-6,1,4,0,6,0,6,0,6,5,1,4,4,44,0,1,0,1,1.02517828825512
1,0,-4,-2,-1,3,2,3,7,4,6,4,5,4,1,2,5,30,1,1,0,0,1.32121726827189
1,1,1,1,0,3,2,5,4,5,4,6,6,3,2,3,2,38,1,1,0,0,1.07447574823435
1,0,0,0,0,3,2,6,6,7,7,5,5,4,3,2,6,30,0,0,0,0,0.60098782069481
0,0,-1,2,-2,2,2,6,7,5,3,3,5,4,1,4,4,35,0,0,1,1,0.865188204160568
0,0,-6,-8,-3,3,3,1,7,0,8,5,8,1,1,2,1,57,0,1,1,1,0.680018879821085
0,-1,-2,-2,-2,3,3,2,4,0,2,2,4,3,1,3,2,46,0,1,0,1,1.27404636955291
0,0,0,0,-1,2,2,1,1,1,1,2,3,1,1,2,1,64,1,0,0,0,0.624616807960007
0,0,0,0,-1,3,3,4,4,4,4,4,5,4,4,2,4,46,0,0,0,0,0.992571793600118
1,2,0,0,4,2,1,0,0,0,0,4,0,3,1,3,2,21,0,1,0,0,1.3226958106287
1,1,-1,-1,3,3,2,2,3,2,3,4,1,3,3,3,4,47,1,1,0,0,1.51247789392761
0,0,-2,-1,1,1,1,3,5,3,4,4,3,1,2,2,2,48,0,1,1,0,1.03636082024193
2,1,0,-3,-4,3,1,2,2,0,3,4,8,1,1,1,1,21,0,1,0,0,0.830774301302301
0,0,0,0,1,4,4,10,10,10,10,10,9,3,5,3,4,46,1,1,1,1,0.926919148595907
-1,-1,-2,-2,-1,2,3,3,5,2,4,5,6,1,1,2,3,69,1,1,1,1,0.829810651993489
1,1,4,3,1,3,2,6,2,7,4,6,5,1,2,2,2,42,1,1,1,1,1.07155769912866
0,0,0,0,-3,4,4,7,7,0,0,4,7,5,5,4,7,62,1,1,1,1,1.08372358471585
1,1,5,0,0,2,1,5,0,0,0,0,0,1,1,1,1,20,0,1,0,0,0.755621983698974
0,0,-1,-1,0,4,4,3,4,6,7,4,4,1,1,1,3,74,1,1,1,1,1.13358762898616
0,0,0,0,-1,4,4,10,10,10,10,6,7,4,4,3,1,61,1,1,1,0,0.737228942291431
-1,-1,-2,-2,-5,2,3,4,6,6,8,2,7,2,4,4,6,60,0,0,1,0,0.684132925579315
0,-1,1,0,0,3,3,3,2,1,1,3,3,3,1,1,1,31,0,1,0,0,1.04577979811021
0,1,-5,-1,4,1,1,0,5,1,2,5,1,1,1,1,1,46,1,1,1,0,1.18571536547696
1,1,0,0,0,3,2,3,3,4,4,6,6,5,4,4,7,69,1,0,1,1,1.11043096054525
1,1,0,0,1,4,3,7,7,7,7,8,7,4,2,3,1,30,1,0,1,1,0.868048318901438
1,2,-1,0,4,2,1,2,3,1,1,5,1,4,4,4,3,52,0,0,0,0,0.734119857916479
0,0,-3,-2,-5,4,4,7,10,8,10,5,10,4,5,4,7,62,0,0,0,1,0.840136161417726
0,0,-3,-1,0,3,3,0,3,0,1,5,5,1,1,2,1,66,1,0,1,1,1.30199831543262
-1,0,-1,1,2,2,3,7,8,9,8,7,5,4,2,3,6,54,0,0,1,1,1.00055608909015
0,1,-3,-3,0,3,3,2,5,1,4,3,3,3,4,3,4,54,1,1,0,0,1.30164870743789
0,1,-3,-3,2,3,3,3,6,4,7,7,5,3,5,3,5,73,1,0,1,1,0.686186727412915
-1,-1,0,0,-2,2,3,2,2,1,1,2,4,4,4,4,5,53,0,0,1,1,0.677080187933414
0,0,-4,-2,-3,2,2,2,6,2,4,2,5,1,1,1,1,66,1,0,0,0,1.03817088521266
1,1,2,1,3,3,2,7,5,6,5,6,3,1,1,1,1,78,1,0,1,1,1.32181666852284
-1,-1,-7,-2,-5,2,3,0,7,4,6,3,8,1,1,2,1,80,0,1,1,1,0.780676308832276
0,0,0,-1,0,2,2,2,2,2,3,2,2,1,1,3,1,61,1,1,0,0,1.03339702357158
0,0,-1,-1,2,1,1,4,5,0,1,5,3,3,1,3,5,33,0,1,1,1,0.966366449080208
-1,-1,-5,-3,2,3,4,0,5,1,4,5,3,5,5,4,7,69,0,0,1,1,0.969024608038976
0,0,-1,0,0,3,3,5,6,7,7,5,5,3,1,3,2,74,0,1,0,0,1.04740406607
0,0,-9,-9,-4,3,3,0,9,0,9,6,10,4,5,4,7,27,1,0,1,1,0.950404237115194
1,2,0,0,0,3,2,5,5,0,0,5,5,1,1,2,1,30,0,0,0,0,0.567724281997821
2,1,-1,3,-1,3,1,1,2,3,0,1,2,1,2,3,1,43,0,1,0,1,0.700602760158204
1,0,-1,3,-6,4,3,7,8,9,6,2,8,1,1,3,1,56,0,1,0,0,0.950088329255838
0,0,0,0,0,4,4,10,10,10,10,10,10,5,5,4,1,37,1,0,0,0,0.941762693110478
2,2,0,2,1,4,2,7,7,8,6,9,8,1,1,3,2,64,1,0,1,1,0.880807004246363
-1,-1,-4,-3,-4,2,3,1,5,3,6,4,8,1,1,4,1,52,1,1,1,1,1.33565298699237
1,0,3,0,2,3,2,3,0,1,1,4,2,2,1,4,1,32,0,1,0,0,0.726778988003959
1,1,-3,-3,1,4,3,5,8,3,6,5,4,1,1,2,1,35,0,1,1,0,0.640095342171041
-1,0,-3,-5,0,2,3,2,5,1,6,3,3,1,1,3,3,57,1,0,0,0,1.26529992434598
0,-1,0,1,-4,3,3,0,0,1,0,0,4,3,4,2,4,54,0,1,0,1,1.6620954441499
1,-1,-4,-4,-5,4,3,4,8,3,7,3,8,4,4,3,7,81,0,0,1,1,0.677864585039849
0,0,0,0,0,2,2,5,5,5,5,5,5,3,3,3,1,35,0,0,0,0,0.726619949982949
0,0,-2,-2,0,1,1,0,2,0,2,2,2,2,5,4,5,28,0,0,1,0,0.704806829116349
-1,0,0,-1,1,3,4,9,9,7,8,9,8,4,5,3,1,22,0,0,0,0,1.23350368995701
0,0,-4,-2,0,2,2,1,5,2,4,5,5,1,1,1,3,61,1,1,1,1,1.37486016079663
-2,-1,-2,-3,-2,1,3,2,4,1,4,6,8,5,1,3,7,56,1,0,0,0,1.26529992434598
0,1,0,-1,0,3,3,8,8,7,8,8,8,4,1,3,2,32,1,1,1,1,0.90915713245011
0,0,-3,-3,-2,4,4,3,6,5,8,3,5,5,4,3,7,71,0,1,0,0,0.615615712705601
-1,-1,-3,-3,1,2,3,3,6,2,5,7,6,2,2,4,3,70,1,0,1,1,0.970366054592694
0,0,-3,-2,-1,3,3,0,3,1,3,4,5,3,5,4,5,46,0,1,0,0,0.70669514514957
1,0,-3,-3,1,3,2,3,6,2,5,6,5,2,2,2,7,66,0,1,1,1,1.07039305224686
0,0,0,-2,-1,1,1,0,0,3,5,1,2,1,1,2,4,71,0,0,0,0,0.871866766783756
-1,0,-2,-2,0,2,3,4,6,5,7,8,8,4,1,3,1,72,1,0,1,1,0.796675653672009
-1,0,-2,-2,2,3,4,5,7,5,7,5,3,3,1,4,2,59,0,1,0,0,1.00928497913445
0,0,-1,-2,-1,2,2,1,2,0,2,3,4,1,4,3,4,50,0,0,1,1,1.02669462306552
0,-1,-10,0,-6,4,4,0,10,10,10,3,9,1,4,4,1,71,0,1,1,1,0.985971652963289
0,1,-4,1,0,2,2,6,10,4,3,4,4,3,2,3,6,22,0,1,0,1,1.24511696776824
-1,-1,-3,-1,-3,2,3,3,6,4,5,2,5,2,2,2,2,44,1,0,1,0,0.69342567367563
-1,-1,-4,-4,-3,3,4,3,7,3,7,4,7,4,4,3,5,67,0,1,1,1,0.94403873874904
0,0,-1,-4,-2,2,2,5,6,3,7,7,9,1,2,1,3,29,1,1,0,1,1.09396718669245
0,0,0,0,2,3,3,2,2,2,2,5,3,2,1,3,6,65,1,0,1,0,1.03503235260843
1,0,1,2,-7,2,1,4,3,3,1,0,7,3,3,4,4,60,0,1,0,0,0.593211074771015
0,0,0,0,-2,2,2,3,3,2,2,5,7,5,4,4,7,34,1,1,1,1,0.808382678014032
0,1,-1,-1,-2,1,1,3,4,3,4,3,5,3,4,4,6,28,0,1,0,0,1.03540565941896
-3,-3,-2,-2,-1,1,4,4,6,2,4,1,2,3,3,3,2,38,0,0,0,0,0.624199981240723
0,1,0,1,0,2,2,7,7,7,6,5,5,3,3,1,4,28,0,1,0,1,0.6585886196855
-1,-1,-3,-2,2,2,3,6,9,6,8,7,5,1,1,3,7,68,1,0,1,1,1.13005266387694
-2,-2,-1,-2,-2,1,3,0,1,1,3,3,5,2,4,3,6,57,1,1,1,1,1.19816770887997
-2,0,-4,-1,2,1,3,2,6,2,3,8,6,3,2,3,7,34,0,1,0,0,0.658168886388622
0,2,-4,1,0,2,2,3,7,5,4,5,5,1,1,3,2,48,1,1,1,1,1.30164870743789
0,0,0,1,0,4,4,9,9,7,6,10,10,1,1,1,1,52,1,0,1,1,1.20854154202459
0,0,1,-1,2,3,3,6,5,5,6,6,4,2,1,2,1,84,0,1,1,0,1.24706620889149
-1,-1,-2,0,0,2,3,5,7,5,5,6,6,5,4,4,6,62,1,0,1,1,0.855536883243929
0,0,0,0,2,2,2,2,2,2,2,6,4,1,1,1,3,67,1,1,1,1,0.851607594104819
0,0,0,-1,1,3,3,5,5,4,5,3,2,3,3,1,4,35,1,1,1,1,1.05007638125218
-1,0,0,0,-5,1,2,0,0,0,0,0,5,3,4,4,6,43,0,1,1,0,1.14506222126633
1,1,-5,-4,-2,2,1,3,8,3,7,4,6,1,4,4,2,30,1,1,1,1,0.701080836366515
0,0,2,0,2,2,2,4,2,5,5,5,3,2,1,1,2,24,1,1,0,0,1.81713921669099
0,1,-5,0,-6,3,3,0,5,10,10,3,9,4,5,4,6,29,1,0,1,1,1.20566232544719
0,0,2,0,1,4,4,8,6,7,7,7,6,1,1,4,1,27,1,0,0,1,1.20566232544719
-1,-1,-3,-2,-2,2,3,2,5,1,3,0,2,2,1,2,4,25,0,1,0,0,1.13918367181579
2,2,-4,-1,5,3,1,2,6,3,4,7,2,4,4,3,5,32,0,0,1,0,0.665694621024762
0,-2,0,0,1,4,4,3,3,2,2,1,0,3,4,4,4,57,1,0,0,0,0.68216513837209
-1,-1,0,-1,-1,2,3,3,3,2,3,6,7,1,1,1,2,72,1,1,1,1,0.872334500128151
-1,-1,0,0,0,1,2,2,2,2,2,7,7,1,1,1,1,61,1,0,1,0,1.10793576143719
-3,0,-3,-3,-3,1,4,0,3,5,8,7,10,3,1,2,1,19,0,1,1,0,0.981500939116013
0,-3,-3,-4,-4,4,4,3,6,1,5,1,5,4,4,4,4,67,0,1,0,0,1.23055060823689
0,0,0,0,-10,1,1,0,0,0,0,0,10,3,2,2,4,40,1,1,0,0,0.759886043535033
0,0,0,1,-2,3,3,7,7,7,6,8,10,1,1,2,1,43,1,1,1,1,1.37966197063957
0,0,-6,-7,-3,4,4,2,8,1,8,5,8,5,5,4,5,39,0,1,0,0,1.02517828825512
0,0,-2,0,0,3,3,3,5,5,5,3,3,3,5,4,7,37,1,1,0,0,1.11603916737083
0,0,0,0,0,2,2,5,5,6,6,7,7,1,1,1,3,63,1,1,1,1,0.80260118314059
1,1,-1,-1,1,3,2,5,6,5,6,6,5,2,2,3,7,34,1,0,1,1,1.36527798203521
-2,-1,2,-1,3,2,4,4,2,6,7,5,2,4,1,2,3,24,1,0,0,0,1.37598614869627
-1,0,0,5,5,2,3,0,0,5,0,7,2,3,2,4,3,47,0,1,0,1,0.816942620381852
-1,-1,0,-2,-2,2,3,3,3,3,5,7,9,1,1,1,1,61,1,1,1,1,1.38657074564303
1,2,1,1,2,2,1,2,1,2,1,3,1,4,2,3,6,56,1,1,0,0,0.743508404251346
-1,-1,-2,-2,-2,2,3,0,2,1,3,2,4,2,1,3,2,72,0,1,1,0,0.777221842105169
-1,-1,0,2,5,3,4,6,6,8,6,8,3,2,1,2,6,64,1,0,1,1,1.09337479978098
-1,-1,-4,-8,-4,2,3,2,6,0,8,4,8,4,4,4,7,62,0,1,0,1,1.08621796451903
2,0,2,-2,-1,4,2,5,3,4,6,6,7,1,1,1,3,70,1,1,1,0,1.12806439225518
0,1,-1,-2,-1,2,2,1,2,1,3,1,2,3,3,3,6,34,1,1,0,0,1.4834951538334
-1,-1,-3,-5,-6,2,3,2,5,1,6,2,8,1,2,1,3,54,1,1,0,0,0.746636505730811
0,1,-1,-1,0,2,2,3,4,2,3,7,7,2,1,1,3,40,1,1,1,0,1.53931777234212
0,1,1,0,0,2,2,5,4,5,5,3,3,4,5,4,5,41,0,1,0,1,0.792772465620885
1,2,-2,-1,1,2,1,6,8,7,8,9,8,4,4,3,3,32,0,1,1,1,0.68401321137491
0,0,0,0,-1,2,2,4,4,5,5,7,8,1,1,3,3,60,1,1,1,1,0.827604008101386
0,0,0,0,0,2,2,3,3,3,3,5,5,4,4,3,7,48,1,1,1,1,0.97082253181206
-1,0,3,1,2,3,4,9,6,8,7,8,6,5,5,3,1,24,0,0,1,1,0.847468308855663
-1,-1,-4,-6,-6,3,4,6,10,3,9,2,8,2,1,3,1,58,0,0,1,1,0.943724588215773
-1,-1,2,2,3,2,3,4,2,8,6,6,3,3,2,3,7,21,0,1,0,0,0.882715853903652
1,0,0,0,-2,4,3,9,9,1,1,3,5,4,1,2,3,19,0,1,0,0,1.21020604397627
2,2,6,3,1,3,1,7,1,5,2,2,1,2,1,1,2,52,1,0,1,1,0.803569090976153
0,1,0,0,0,2,2,5,5,5,5,5,5,2,2,2,7,61,1,1,1,0,1.25334302465588
-1,-1,-1,0,-2,3,4,8,9,9,9,5,7,1,1,1,1,47,1,0,1,1,1.0749583145738
-1,0,0,0,-2,2,3,4,4,5,5,4,6,2,2,3,7,20,0,1,0,0,0.866436997175541
0,2,0,0,0,2,2,8,8,8,8,8,8,4,4,3,4,24,1,1,1,0,1.43234685387862
-1,-1,-2,-1,1,3,4,5,7,4,5,8,7,4,2,4,7,64,1,1,1,1,0.718009250408674
-1,-1,0,3,4,2,3,5,5,7,4,8,4,1,1,1,1,63,0,0,1,0,1.06583427201199
-1,-1,-2,-2,-3,2,3,6,8,3,5,4,7,1,1,2,1,32,0,1,0,0,1.26027649428828
0,0,0,-1,0,2,2,0,0,1,2,5,5,1,1,1,4,44,0,0,0,0,1.18324841515281
0,0,0,0,-2,4,4,6,6,8,8,7,9,4,1,3,2,25,1,0,0,1,0.72985001311258
-1,-3,1,0,3,3,4,5,4,0,0,8,5,3,2,2,4,54,1,1,0,0,1.32437243915255
1,1,-2,0,-1,3,2,6,8,6,6,7,8,2,4,2,7,51,1,1,1,1,1.30164870743789
-1,-1,-3,-3,-5,2,3,7,10,3,6,5,10,3,1,3,4,24,0,1,1,1,0.777419479769794
0,0,1,2,-1,2,2,3,2,4,2,4,5,1,1,2,1,19,0,1,0,1,0.928692669863411
-1,0,0,0,0,3,4,8,8,8,8,8,8,4,2,4,6,40,1,0,1,1,1.26971908623912
0,1,-3,0,0,2,2,4,7,4,4,7,7,1,1,2,1,59,1,1,1,1,0.80260118314059
1,1,-2,-1,-2,3,2,4,6,5,6,4,6,2,1,2,6,32,1,1,1,0,0.986437363898676
0,0,-2,-2,2,2,2,3,5,2,4,6,4,4,4,3,4,65,1,0,1,0,0.610111036350513
0,0,-1,0,-1,2,2,4,5,3,3,5,6,4,2,2,4,63,0,1,1,1,0.704877638734187
1,1,-3,-3,3,3,2,4,7,4,7,9,6,4,1,1,4,60,1,1,1,1,1.37486016079663
0,0,-1,-1,1,3,3,6,7,5,6,7,6,2,4,3,3,68,1,0,1,1,1.14978073137367
0,0,0,0,0,2,2,7,7,4,4,7,7,1,1,2,1,68,1,1,1,0,1.18395006359059
0,0,-1,1,1,3,3,6,7,6,5,6,5,1,2,3,2,63,0,1,1,1,0.695579587009629
0,-2,-4,-4,-3,3,3,1,5,0,4,2,5,3,5,4,6,27,0,1,0,1,1.21426916575533
0,1,0,0,3,1,1,5,5,5,5,6,3,3,1,1,4,41,0,1,1,1,1.34406623650394
0,-1,0,0,4,4,4,5,5,3,3,9,5,2,4,3,4,55,0,1,1,1,1.03143730714755
0,0,-2,9,-3,3,3,8,10,10,1,7,10,4,4,2,7,58,0,1,1,1,0.692987805685927
0,-1,-2,-4,-1,3,3,4,6,2,6,5,6,2,1,3,3,68,1,1,1,0,0.858861293987159
0,0,0,0,3,4,4,1,1,0,0,8,5,5,2,4,7,69,1,0,1,1,0.845719316654506
1,1,0,0,0,2,1,3,3,5,5,2,2,1,1,2,1,66,0,0,1,1,0.874510531751299
-1,0,-5,-5,-8,2,3,3,8,4,9,2,10,5,4,4,7,53,0,1,0,1,0.741767793972769
0,0,0,0,-2,2,2,5,5,5,5,5,7,4,3,1,4,32,1,1,0,1,0.907731183205704
0,2,-1,0,0,2,2,4,5,4,4,5,5,4,5,2,6,46,0,0,0,0,0.874625581910835
0,2,1,0,0,2,2,9,8,8,8,8,8,5,5,4,1,36,0,0,1,1,0.865188204160568
0,1,0,0,-3,2,2,2,2,3,3,5,8,1,1,2,2,35,1,0,1,1,1.20888360656926
0,-1,-4,2,5,4,4,5,9,6,4,6,1,5,1,3,7,32,1,1,1,1,1.17290017046353
0,-3,-10,-10,-7,4,4,0,10,0,10,0,7,3,3,4,7,19,0,1,0,0,1.90263565075637
2,0,0,0,0,4,2,6,6,7,7,7,7,5,1,1,7,24,0,0,1,0,1.39680521910051
0,-1,-3,-6,1,4,4,3,6,1,7,5,4,2,3,3,3,46,1,1,0,0,1.36715246896492
-1,-2,-4,-6,-4,3,4,1,5,1,7,5,9,2,1,4,6,53,0,0,1,0,0.832673599097802
1,1,-6,-6,-3,2,1,1,7,1,7,2,5,1,1,1,3,40,0,1,1,1,0.677599174329044
0,0,0,0,0,3,3,5,5,5,5,5,5,4,4,3,1,35,1,0,1,1,0.757313627500052
0,0,-5,0,-1,2,2,0,5,4,4,4,5,3,2,2,3,21,0,1,0,0,1.5306799731039
-1,-1,-5,-2,-4,2,3,0,5,0,2,0,4,3,1,3,4,47,0,1,0,0,0.827687424568298
0,0,0,-2,-1,4,4,8,8,6,8,7,8,3,1,3,6,36,1,1,0,1,1.5263171292554
0,0,-2,0,-1,3,3,5,7,6,6,8,9,1,1,2,3,40,1,1,1,1,0.804408533792947
-3,-3,0,-4,-1,1,4,0,0,1,5,4,5,3,1,2,7,49,0,1,1,0,0.77298817862665
1,1,2,2,-2,2,1,5,3,4,2,4,6,3,2,4,1,50,1,1,1,0,0.78320786897536
-1,-1,2,0,-2,1,2,2,0,1,1,2,4,3,2,2,1,24,0,1,0,0,1.06554471048945
-2,-2,-9,-5,-9,2,4,1,10,5,10,1,10,1,4,3,1,64,1,1,0,0,1.19816770887997
1,1,-4,-5,2,3,2,2,6,2,7,5,3,4,1,3,3,23,1,1,0,1,1.02858642827019
0,-1,-1,1,1,2,2,0,1,1,0,2,1,1,1,3,3,56,1,1,0,0,1.38657074564303
1,0,2,0,1,4,3,4,2,5,5,8,7,1,1,1,2,75,1,1,1,0,1.4267864403679
1,1,0,2,1,3,2,4,4,6,4,6,5,1,1,1,1,25,1,1,0,0,1.49613105409698
-2,-2,-4,-4,0,1,3,0,4,0,4,0,0,4,4,4,5,51,0,1,0,0,0.741767793972769
2,0,-3,4,6,4,2,6,9,6,2,8,2,1,1,1,1,49,1,1,0,0,1.51247789392761
0,0,0,1,2,2,2,4,4,3,2,5,3,1,1,2,7,57,1,1,1,1,0.731458772592179
0,0,0,1,-1,3,3,6,6,6,5,5,6,4,5,3,7,58,0,1,1,1,0.610360777532627
-2,-3,0,0,0,2,4,0,0,0,0,0,0,3,3,4,4,44,0,1,0,1,1.15279184168449
-1,-2,-3,-5,-3,3,4,3,6,2,7,5,8,1,1,3,1,64,1,1,1,1,0.743508404251346
-1,-1,-2,-1,-3,1,2,2,4,1,2,0,3,3,2,3,4,54,0,1,0,0,1.27404636955291
0,-1,-3,0,4,4,4,5,8,3,3,9,5,1,1,4,1,49,0,1,0,1,1.10093280448241
1,1,-2,0,0,2,1,0,2,0,0,2,2,3,4,4,4,60,0,0,1,0,0.526150352172524
0,0,-2,-1,1,4,4,7,9,9,10,7,6,4,4,3,7,64,0,1,1,0,1.05576229363635
0,-3,-6,6,-6,4,4,0,6,6,0,4,10,5,4,4,7,70,0,0,0,0,1.02865294982216
-1,1,0,0,0,1,2,1,1,1,1,6,6,4,2,3,2,69,1,0,0,1,1.30199831543262
1,-1,-1,0,0,4,3,7,8,8,8,8,8,2,2,3,1,27,1,0,1,1,1.35374722985557
0,0,-3,-3,2,3,3,0,3,0,3,7,5,1,1,3,4,54,0,0,1,0,1.05090776007454
1,2,2,1,4,3,2,9,7,6,5,10,6,3,5,4,7,36,1,0,1,1,1.39282395380352
3,3,2,-2,2,4,1,4,2,7,9,8,6,4,2,3,4,28,0,0,1,1,0.758707607221104
0,1,0,-2,-1,3,3,6,6,5,7,6,7,3,1,3,2,22,0,1,0,0,1.3226958106287
0,0,0,0,0,2,2,0,0,5,5,6,6,2,1,3,4,35,1,0,0,0,1.40468754804547
0,3,0,0,0,1,1,0,0,5,5,5,5,3,5,1,2,55,0,0,1,1,1.06583427201199
-1,0,0,0,3,3,4,4,4,3,3,8,5,1,1,2,3,49,1,0,0,0,0.83294434936288
0,0,0,0,0,2,2,6,6,2,2,4,4,3,3,4,5,52,0,0,0,1,0.915902622766304
0,1,0,0,1,1,1,0,0,0,0,3,2,1,1,1,4,27,0,0,0,0,0.682345993448115
0,1,0,0,0,1,1,1,1,4,4,5,5,1,1,2,1,42,1,1,0,0,1.34787426710328
-1,0,-2,-2,-1,1,2,2,4,2,4,6,7,3,2,3,5,74,1,0,1,1,0.707929429678896
0,0,0,2,2,2,2,7,7,6,4,6,4,4,2,3,5,59,0,0,0,1,0.741953962132129
-2,-2,0,0,-4,1,3,0,0,0,0,1,5,5,4,3,5,30,0,0,0,0,1.03954956376656
0,-1,0,-2,-4,2,2,3,3,0,2,1,5,3,4,3,1,52,0,0,0,0,0.573927279977422
-1,0,5,0,-1,2,3,7,2,3,3,1,2,3,4,3,6,58,0,1,0,1,0.64786587512217
1,1,0,1,0,4,3,4,4,5,4,5,5,3,1,4,7,55,0,1,1,1,0.699635446279914
-1,-1,-4,-3,-3,3,4,0,4,1,4,5,8,4,2,3,4,65,1,0,0,0,0.842839225327868
-1,-1,-2,-2,-2,2,3,4,6,3,5,2,4,1,1,4,1,56,1,1,0,1,1.01385697035524
0,-1,-2,-3,-1,4,4,5,7,3,6,9,10,1,1,1,1,65,1,0,1,1,0.834865936563628
-2,0,0,-3,-1,2,4,0,0,2,5,4,5,5,1,4,5,49,0,1,1,1,1.15163047784248
-1,-1,-1,-1,-1,1,2,2,3,0,1,0,1,4,1,4,4,18,0,1,0,0,1.42351861050294
0,0,-2,-1,0,1,1,0,2,0,1,0,0,1,1,3,3,58,0,0,1,1,0.720667498342758
0,0,-1,-1,-1,3,3,4,5,5,6,5,6,1,1,2,5,74,1,0,1,1,1.30199831543262
1,1,2,4,-7,3,2,5,3,7,3,1,8,3,4,3,2,18,0,0,0,0,1.19250743351255
0,0,-2,-3,0,3,3,7,9,4,7,3,3,1,1,4,2,68,0,1,1,1,0.705702110359145
1,1,-3,-6,2,3,2,1,4,0,6,5,3,1,4,4,1,53,0,0,1,1,0.573927279977422
1,1,0,0,0,4,3,9,9,9,9,9,9,4,3,1,4,33,1,0,1,1,0.836707967624271
0,0,3,2,4,4,4,7,4,2,0,9,5,4,4,4,6,58,1,1,1,0,1.08700976393145
1,-1,-2,-3,-3,4,3,3,5,2,5,2,5,3,4,3,7,28,0,1,0,0,0.680946822606933
-1,0,-3,2,0,2,3,5,8,6,4,6,6,1,1,1,1,50,1,1,1,1,1.51247789392761
-1,0,-3,-1,1,2,3,4,7,3,4,5,4,4,2,2,2,46,1,1,1,1,0.912776682708028
-1,-2,-3,-1,-1,3,4,0,3,1,2,6,7,4,4,3,5,72,1,0,1,0,1.30199831543262
0,0,-2,0,0,2,2,3,5,2,2,5,5,3,1,2,3,54,1,1,0,0,1.29065535013784
-1,-1,-3,-4,-5,2,3,3,6,2,6,2,7,1,1,1,3,29,0,1,0,0,0.680946822606933
1,0,-3,2,-4,3,2,4,7,7,5,4,8,3,1,1,3,18,0,1,0,0,1.29740853872123
0,0,-3,4,-2,4,4,5,8,5,1,5,7,5,4,3,6,53,0,1,1,1,1.15163047784248
0,1,-3,-1,-5,2,2,3,6,4,5,2,7,1,1,3,2,50,0,1,1,0,1.09645292457005
0,0,1,1,-1,4,4,8,7,8,7,7,8,4,5,3,1,37,1,1,1,1,1.21703537278988
1,1,-1,-2,-2,3,2,2,3,3,5,2,4,5,2,4,5,35,0,0,0,0,0.959045880914422
-1,0,-4,-3,1,3,4,2,6,2,5,7,6,3,1,4,2,25,1,1,0,0,1.35237630428578
1,1,1,2,3,3,2,8,7,8,6,8,5,2,1,3,6,33,0,0,1,0,0.600604797678889
1,1,-3,-1,-2,3,2,2,5,3,4,6,8,4,1,4,1,20,0,1,0,0,1.3226958106287
0,0,0,0,0,4,4,5,5,3,3,8,8,2,2,2,3,73,1,0,1,0,1.12508672454647
0,0,-2,0,-4,4,4,0,2,10,10,2,6,3,1,4,3,22,0,1,0,0,0.911576239334795
1,0,0,-1,0,2,1,2,2,0,1,0,0,4,2,4,7,31,0,1,1,0,1.13918367181579
-1,0,-3,-4,-5,2,3,3,6,4,8,2,7,4,4,4,7,27,0,1,0,1,1.03474577217214
0,0,0,-3,0,2,2,0,0,1,4,6,6,1,1,1,4,48,1,0,1,1,0.803569090976153
3,3,0,0,3,4,1,0,0,0,0,3,0,5,3,4,2,72,0,1,0,1,1.21210063175364
0,0,0,-2,1,1,1,7,7,5,7,8,7,4,5,4,7,35,0,0,0,0,1.02247220134593
0,0,0,0,0,4,4,5,5,5,5,5,5,3,1,1,2,54,0,1,1,1,1.27404636955291
-1,0,-1,-1,-1,3,4,6,7,5,6,7,8,2,5,2,6,54,0,0,0,0,1.16261703924884
0,0,-2,-3,-5,2,2,6,8,5,8,4,9,1,1,1,2,18,0,1,0,0,0.938074257573367
0,0,-3,-2,-2,2,2,2,5,1,3,3,5,3,5,3,7,45,0,1,1,0,0.755914359332089
0,0,0,2,-5,2,2,2,2,5,3,2,7,4,4,3,7,69,1,1,1,0,0.830695220860257
0,0,-2,0,0,2,2,1,3,10,10,5,5,5,4,3,5,22,0,0,0,0,0.689534552645617
0,1,-1,0,1,2,2,2,3,2,2,6,5,3,1,1,2,23,0,1,0,1,0.825240320942513
0,0,1,0,0,2,2,3,2,3,3,3,3,5,4,2,4,61,0,0,1,0,0.884431277465904
0,0,-2,-2,2,3,3,5,7,5,7,10,8,2,1,1,1,78,1,0,1,1,0.760066673113708
-3,0,1,-3,1,1,4,9,8,7,10,9,8,5,5,3,7,36,0,0,1,1,1.06955678404937
2,2,1,-4,-2,3,1,5,4,3,7,3,5,3,1,3,5,20,0,1,0,0,1.21020604397627
0,1,2,1,1,3,3,8,6,8,7,8,7,4,5,3,2,33,1,1,1,1,1.4834951538334
0,0,-2,0,-5,1,1,3,5,0,0,0,5,3,2,4,7,22,0,1,0,0,1.3226958106287
-1,-2,-6,-5,-2,3,4,2,8,2,7,5,7,4,3,3,4,48,0,1,1,1,1.10093280448241
0,1,0,0,2,2,2,2,2,2,2,8,6,4,4,3,4,64,1,1,1,1,0.74754625868897
1,1,1,2,1,3,2,7,6,8,6,7,6,1,1,1,1,50,1,1,1,0,0.817215127633449
-1,1,1,0,1,2,3,10,9,4,4,7,6,4,4,4,5,19,0,1,0,0,0.850907977989837
0,0,1,-1,0,3,3,7,6,6,7,6,6,1,1,2,1,42,0,1,0,0,0.69906976901492
-1,-1,-6,-5,-4,3,4,1,7,0,5,4,8,1,1,1,3,27,0,0,0,1,0.993785974456062
-3,-3,-5,-3,0,1,4,1,6,5,8,0,0,3,1,3,4,31,0,1,0,0,1.71213390150467
0,0,0,0,-1,3,3,3,3,3,3,3,4,3,1,3,4,25,0,1,0,0,0.754917353489195
-2,0,-10,-7,-1,1,3,0,10,3,10,2,3,3,2,4,6,67,0,1,0,1,0.764262111353379
1,0,1,0,0,4,3,9,8,8,8,8,8,5,5,4,1,30,0,1,1,1,0.772358009178968
1,1,-3,-6,-4,3,2,5,8,1,7,5,9,2,1,2,3,40,0,0,0,1,1.02247220134593
0,0,0,0,4,4,4,5,5,7,7,9,5,2,4,2,7,20,0,1,0,0,1.3173135399142
-1,0,-3,-4,1,2,3,3,6,3,7,2,1,4,1,3,7,32,1,1,1,1,0.866018959310102
0,-1,1,1,0,2,2,8,7,9,8,9,9,4,4,4,7,50,1,1,1,1,1.25505699243484
0,1,0,-1,1,2,2,7,7,6,7,8,7,4,2,3,3,28,0,0,1,1,1.15005149062081
0,0,2,0,-4,3,3,2,0,0,0,3,7,5,1,4,1,33,1,1,0,0,1.24149235409135
1,2,0,0,0,3,2,5,5,5,5,5,5,2,1,3,1,26,0,1,1,0,0.993403837763288
0,0,-2,-2,-2,2,2,2,4,0,2,2,4,4,4,4,7,19,0,1,0,0,1.3173135399142
0,0,0,0,0,4,4,4,4,0,0,3,3,3,3,4,6,64,0,1,0,0,0.748935731780454
1,1,-1,-2,-3,2,1,2,3,1,3,0,3,1,1,1,1,28,1,1,0,0,1.04149434166787
0,0,-3,-2,-3,4,4,3,6,3,5,6,9,3,1,4,2,52,1,1,0,1,1.32437243915255
0,0,-3,-3,-2,3,3,1,4,1,4,2,4,1,1,1,2,36,1,0,1,1,0.741015943829366
0,-1,0,0,0,3,3,8,8,8,8,8,8,4,4,3,1,35,1,0,1,1,0.753223014837717
0,0,1,2,1,3,3,6,5,5,3,3,2,2,4,4,4,73,0,0,1,1,0.662557690191256
-1,0,-1,-1,-1,2,3,7,8,7,8,7,8,4,4,3,1,38,1,0,1,1,0.734054183783787
0,0,-1,-1,0,2,2,2,3,3,4,5,5,1,1,1,1,45,0,0,0,0,0.590483412408884
1,0,0,0,1,3,2,6,6,5,5,5,4,3,1,3,1,24,0,1,0,0,1.06554471048945
1,1,1,1,3,4,3,6,5,7,6,9,6,3,4,4,6,36,1,0,1,1,1.39282395380352
0,-1,0,1,-1,3,3,6,6,7,6,6,7,1,1,3,1,28,1,0,0,0,1.17976814155326
0,0,-3,-2,-3,3,3,6,9,5,7,3,6,4,2,4,1,50,0,1,1,1,0.760441459811715
0,0,-1,0,0,3,3,8,9,8,8,8,8,5,5,3,7,32,1,0,1,0,0.989856499858333
-1,-1,-3,-2,-1,2,3,1,4,1,3,3,4,2,2,4,4,77,0,1,1,1,1.24706620889149
0,0,0,0,-4,4,4,0,0,10,10,6,10,1,4,4,5,21,0,0,0,0,1.10436025042204
0,0,0,0,0,4,4,9,9,9,9,9,9,5,5,4,1,45,0,0,1,1,0.786107498330382
-2,-1,-5,-6,-4,2,4,4,9,1,7,3,7,3,1,4,3,25,0,1,0,0,1.12153992207553
1,1,0,0,1,3,2,5,5,5,5,7,6,2,2,2,5,25,1,1,0,0,1.49613105409698
-1,-1,0,-2,-1,2,3,6,6,4,6,8,9,3,4,4,2,24,1,1,0,0,1.05183099371608
0,0,0,0,0,1,1,0,0,0,0,1,1,1,1,1,4,40,1,0,0,0,1.24046449000709
-1,-1,-5,-4,3,3,4,2,7,3,7,8,5,3,2,3,6,65,1,1,1,1,1.11124574671694
-1,-1,-1,-4,-5,2,3,0,1,1,5,2,7,1,1,4,6,52,0,1,0,0,0.768883845169354
0,0,0,0,0,4,4,10,10,10,10,10,10,5,5,4,1,34,0,1,1,1,0.622136985755584
-1,1,1,-3,1,1,2,3,2,2,5,3,2,3,4,2,4,39,0,1,0,0,1.14810093866691
0,0,0,0,1,2,2,1,1,0,0,2,1,1,1,1,1,59,0,1,1,0,0.576578463410007
0,0,-1,-3,-2,4,4,0,1,2,5,3,5,2,1,4,4,65,0,0,0,1,0.583496084949682
0,0,0,0,0,2,2,0,0,5,5,5,5,3,3,2,4,35,0,0,0,0,1.0529914200105
0,0,2,1,2,2,2,2,0,4,3,7,5,1,1,1,3,28,0,0,0,0,0.634471279926295
0,0,-1,-4,-4,3,3,2,3,0,4,3,7,1,1,3,3,59,0,0,0,0,0.81727024618822
-1,-1,-1,-1,-1,1,2,0,1,1,2,1,2,1,1,1,4,34,0,1,0,0,0.808940627747604
1,1,-1,-1,-2,4,3,7,8,9,10,6,8,5,4,4,1,40,1,0,1,1,0.838417403904922
0,0,0,0,-1,4,4,9,9,9,9,9,10,5,5,4,7,43,1,1,1,1,0.824692679874148
0,0,-2,0,-2,1,1,1,3,1,1,2,4,1,1,1,1,30,1,1,0,0,0.738566868865446
-1,-1,-2,-2,0,1,2,3,5,1,3,5,5,3,3,4,4,55,0,1,1,1,0.812520488638325
-1,-1,-2,-3,-2,2,3,1,3,0,3,3,5,4,2,4,7,61,0,0,1,0,0.839657748178806
-1,-1,-2,2,-4,2,3,3,5,5,3,3,7,4,5,1,7,69,0,0,0,0,0.747885962492009
2,0,0,-1,-4,3,1,0,0,0,1,3,7,5,5,4,5,61,1,1,0,0,0.807281075290642
-1,-1,-1,0,1,1,2,1,2,1,1,5,4,1,1,2,7,57,1,1,1,1,1.38657074564303
0,0,-5,0,0,4,4,0,5,0,0,0,0,3,1,3,2,72,1,1,0,0,1.23836090923475
0,-1,0,0,-1,3,3,5,5,5,5,8,9,3,4,3,7,56,0,0,0,0,0.588009528501818
0,0,-4,-5,-5,3,3,3,7,2,7,2,7,1,4,2,4,61,1,0,0,0,0.661847292346912
-2,-2,-7,-4,-7,1,3,0,7,1,5,0,7,1,1,3,4,63,0,1,1,1,0.593211074771015
0,1,0,-1,-2,3,3,5,5,6,7,5,7,2,3,3,2,41,1,1,1,1,1.53931777234212
1,0,0,0,0,3,2,4,4,5,5,4,4,3,4,3,4,29,0,1,1,0,0.830932436971272
0,0,0,0,0,4,4,10,10,10,10,10,10,3,1,3,4,27,1,1,0,1,1.49613105409698
-1,-2,-3,-2,-6,3,4,7,10,7,9,2,8,1,1,3,2,58,1,0,1,1,0.925184057084089
0,0,0,0,0,4,4,9,9,9,9,9,9,2,1,4,1,34,1,0,1,1,1.07943377753631
0,1,5,2,4,2,2,7,2,8,6,7,3,4,4,3,5,41,0,1,1,1,0.902634148784906
0,0,0,0,-1,3,3,7,7,8,8,7,8,2,4,2,7,31,1,0,1,1,0.868048318901438
0,0,2,1,3,3,3,5,3,5,4,6,3,2,1,4,1,19,0,1,0,0,1.79351860394865
0,-1,0,-3,2,4,4,7,7,1,4,5,3,5,5,4,7,50,1,1,1,1,0.811022465974532
0,0,-5,-6,-1,4,4,1,6,1,7,9,10,4,5,4,7,67,1,0,1,1,1.02940278717328
-1,-1,-1,0,-5,2,3,0,1,0,0,5,10,4,5,3,6,31,0,0,1,1,0.921550751404893
0,0,-1,-2,-3,2,2,4,5,4,6,3,6,1,2,1,3,49,0,0,1,0,1.02669462306552
-1,-1,-4,0,-2,2,3,2,6,5,5,4,6,3,1,3,2,52,0,1,1,1,1.18485166695204
-1,0,-2,-3,-2,3,4,3,5,2,5,5,7,3,5,4,7,48,0,1,1,1,0.763165636972826
1,-1,0,-1,0,4,3,9,9,8,9,8,8,4,5,4,1,42,0,0,1,1,0.935515201547666
-2,-2,-6,-4,-2,1,3,0,6,2,6,2,4,1,1,1,3,56,1,1,0,0,0.749185553999051
2,2,0,-2,-2,3,1,9,9,8,10,7,9,4,2,4,1,22,1,1,1,1,1.60469612964171
2,1,-4,-5,-5,3,1,1,5,0,5,0,5,3,5,4,7,35,0,1,1,1,0.902634148784906
1,2,2,0,2,2,1,10,8,5,5,7,5,3,3,2,4,56,0,0,1,0,0.763357175542007
0,0,0,-2,-4,1,1,1,1,1,3,1,5,3,4,4,4,64,0,0,0,0,0.614647624631183
-1,-1,-3,-1,-1,3,4,0,3,2,3,6,7,2,2,2,2,68,1,1,1,1,1.28969462130069
-1,-1,-3,-1,4,3,4,1,4,3,4,8,4,4,2,3,4,60,0,0,1,0,0.556978032359704
-1,-1,-3,-4,-1,3,4,4,7,4,8,4,5,4,5,4,3,74,0,1,0,0,1.24706620889149
1,1,1,-2,-3,3,2,5,4,3,5,4,7,1,4,3,7,53,0,0,1,0,1.19615515869428
0,0,0,0,-2,2,2,5,5,2,2,7,9,1,4,1,1,57,1,1,1,1,1.01385697035524
0,1,-1,-1,1,2,2,7,8,6,7,7,6,4,1,3,1,59,0,0,1,1,0.683433086800297
-1,-1,-4,1,-3,2,3,2,6,2,1,2,5,1,4,3,1,31,0,1,0,1,0.640083827953232
-1,-1,-3,-2,2,2,3,3,6,5,7,7,5,1,1,1,2,66,1,1,1,1,0.745127316765239
0,0,2,3,2,3,3,5,3,3,0,7,5,3,1,2,2,18,0,1,0,0,1.35172704765725
0,1,-8,-8,-9,1,1,0,8,0,8,0,9,3,5,4,6,68,0,0,1,1,0.677864585039849
1,1,7,9,5,3,2,8,1,10,1,9,4,3,2,2,5,51,1,0,1,1,1.01995768057852
0,1,0,1,-1,3,3,7,7,7,6,6,7,4,4,1,1,34,1,0,1,1,1.36527798203521
1,1,-5,-5,2,2,1,2,7,3,8,7,5,2,4,3,6,70,0,0,1,1,0.951907792898236
-2,-1,-1,-3,-2,1,3,2,3,4,7,1,3,4,4,3,2,56,0,1,0,0,0.627567692348746
0,0,0,-1,0,4,4,5,5,4,5,6,6,2,1,3,7,66,0,1,0,1,1.0919075147224
0,0,1,0,-1,4,4,9,8,9,9,8,9,4,5,4,1,39,1,0,1,1,1.40468754804547
0,1,0,2,1,2,2,7,7,8,6,8,7,4,4,3,7,21,0,1,1,0,1.21020604397627
-1,-1,-2,-2,-1,2,3,1,3,1,3,5,6,4,1,3,5,67,1,0,1,1,0.685749405223065
-1,-3,0,0,0,3,4,0,0,0,0,4,4,1,2,2,1,53,0,1,1,1,0.86424314834205
0,0,-2,-2,1,3,3,5,7,4,6,5,4,4,4,3,7,57,0,1,1,1,0.770084014736023
0,0,-1,-1,-1,2,2,5,6,4,5,4,5,3,2,2,6,34,1,0,0,0,1.17496746745483
0,-1,-2,0,0,3,3,2,4,2,2,5,5,3,5,3,6,63,0,1,1,1,0.610360777532627
0,0,-3,-4,-3,2,2,4,7,1,5,5,8,2,1,4,3,45,1,0,1,0,0.681334953289397
0,0,-3,-1,-2,3,3,5,8,2,3,1,3,3,2,3,5,61,0,1,1,0,0.923449497630448
0,0,2,3,1,3,3,6,4,6,3,8,7,1,1,1,3,34,1,1,0,0,1.17290017046353
0,1,0,0,0,2,2,5,5,5,5,5,5,3,1,3,1,21,0,1,0,0,0.908179638404634
-1,-2,-2,-1,-2,3,4,6,8,6,7,2,4,3,4,3,2,71,1,1,1,1,1.23836090923475
-1,-1,-2,-4,2,3,4,7,9,4,8,4,2,4,4,3,6,66,0,0,0,0,0.769976382131821
0,0,0,1,0,3,3,2,2,2,1,4,4,2,1,3,4,18,0,0,0,0,1.93926324160529
-1,-1,-2,0,-3,2,3,5,7,6,6,4,7,1,1,2,2,65,0,0,0,1,0.769976382131821
0,0,0,-1,0,3,3,3,3,5,6,4,4,4,1,3,2,50,0,1,1,1,1.12509666811802
0,0,0,1,-1,3,3,7,7,7,6,6,7,3,4,4,7,53,0,0,1,1,0.607554258586838
-1,-1,-5,-4,-5,2,3,4,9,2,6,3,8,2,2,1,2,45,0,1,1,1,1.12509666811802
0,2,7,0,0,2,2,7,0,8,8,7,7,5,1,4,7,54,0,0,0,0,0.733061372822
0,0,0,-2,-1,2,2,1,1,6,8,5,6,1,2,1,2,35,1,0,1,0,1.11059227951854
0,0,0,0,0,3,3,8,8,7,7,8,8,4,4,3,6,38,1,1,1,1,1.21703537278988
0,0,0,0,0,4,4,10,10,10,10,10,10,4,4,3,1,57,1,1,1,1,0.889095377814188
0,0,0,2,2,2,2,2,2,4,2,6,4,4,4,3,4,68,0,1,1,1,0.778017721022229
0,0,-2,-1,0,4,4,8,10,9,10,9,9,5,4,4,7,44,1,1,1,1,0.891017114844844
1,1,1,1,-1,4,3,8,7,8,7,7,8,1,5,1,7,38,1,0,0,1,1.19867371710734
1,1,-1,1,-2,3,2,5,6,7,6,3,5,3,3,3,6,32,0,1,1,0,0.921510937919353
-1,0,-3,-2,-4,2,3,2,5,4,6,3,7,2,1,2,2,59,0,0,1,0,0.541328259223347
0,0,-1,-1,0,4,4,0,1,4,5,3,3,4,4,4,7,56,0,0,0,1,0.541328259223347
-1,-1,-3,-6,-5,3,4,4,7,3,9,3,8,1,1,2,1,64,1,1,1,0,1.22446573634549
-1,-1,-4,-5,-3,2,3,0,4,1,6,4,7,2,1,2,2,28,0,0,0,1,0.60098782069481
0,0,0,0,1,2,2,1,1,1,1,3,2,3,4,4,6,64,0,1,1,0,0.79229869833117
1,0,1,-1,-6,3,2,8,7,6,7,3,9,2,1,2,2,41,0,0,1,0,0.84744991963014
1,-1,-1,-1,4,3,2,0,1,4,5,7,3,1,1,2,1,25,0,0,0,0,1.03954956376656
0,0,-1,-1,-1,3,3,6,7,4,5,8,9,2,4,3,3,47,0,0,1,0,0.74549202701142
0,0,-3,-2,3,3,3,5,8,3,5,8,5,4,1,4,7,66,0,1,1,1,0.668703136772652
1,1,0,-2,-5,3,2,6,6,5,7,3,8,4,1,1,2,38,1,1,0,0,1.26654081585985
1,1,4,6,2,2,1,5,1,7,1,7,5,3,2,3,1,54,1,1,1,1,0.746636505730811
0,0,0,-1,-2,2,2,4,4,2,3,7,9,2,2,3,5,56,1,0,1,1,0.943015118307642
1,1,2,-2,0,3,2,5,3,4,6,6,6,2,4,2,6,64,1,1,1,1,0.858663649717652
-1,-1,0,-2,-1,2,3,4,4,3,5,4,5,3,4,4,4,70,0,1,1,1,0.651269925035392
-1,-1,-6,-2,0,3,4,2,8,6,8,2,2,1,1,2,1,69,0,1,1,0,0.911851611143564
0,-1,-1,0,2,3,3,7,8,7,7,8,6,4,4,3,4,30,1,0,1,1,1.35374722985557
0,0,-1,-1,0,2,2,0,1,2,3,0,0,1,4,4,2,78,0,1,1,0,1.07039305224686
0,0,-2,0,0,2,2,3,5,5,5,6,6,3,2,2,6,49,0,1,0,0,1.12808240178319
0,0,0,0,-2,4,4,7,7,6,6,3,5,2,5,2,2,49,0,1,0,0,1.31079890102165
1,1,3,3,1,3,2,7,4,6,3,3,2,3,1,3,4,55,1,1,0,0,1.02466924421912
0,0,-1,-3,-1,3,3,6,7,5,8,7,8,3,4,4,6,30,0,1,1,1,0.73395470459653
-2,-2,-4,-3,-4,1,3,1,5,5,8,1,5,4,2,4,4,58,0,1,0,1,0.661136022045745
-1,-1,-8,-8,-2,1,2,0,8,0,8,5,7,4,5,3,7,45,0,0,1,1,0.919203355666582
0,1,0,4,1,2,2,6,6,7,3,6,5,4,5,3,7,43,1,0,1,1,1.20888360656926
-2,-2,-7,-6,-3,1,3,0,7,0,6,6,9,3,4,4,4,34,0,1,0,1,1.04577979811021
2,2,0,0,-2,4,2,7,7,7,7,5,7,4,1,3,1,40,0,1,0,0,0.815641645021719
-1,-1,2,3,-3,2,3,3,1,6,3,2,5,4,4,4,6,67,1,1,1,0,1.13767285583161
0,0,-2,-4,-5,4,4,0,2,1,5,1,6,5,5,4,7,52,0,1,0,0,0.803320568316082
1,1,0,-2,-1,3,2,2,2,5,7,3,4,4,4,3,6,64,0,0,1,1,0.526150352172524
1,1,1,1,2,2,1,6,5,7,6,8,6,1,1,1,1,66,1,1,1,1,0.868396331719577
0,0,0,0,-2,2,2,7,7,6,6,5,7,3,4,3,4,58,1,0,0,0,0.925184057084089
0,0,0,-2,0,3,3,3,3,0,2,5,5,5,4,3,7,52,0,0,1,1,1.02669462306552
0,0,0,0,1,4,4,3,3,1,1,4,3,4,4,3,7,56,1,1,1,1,0.80260118314059
-1,1,-5,-3,-5,2,3,2,7,3,6,0,5,3,5,4,5,32,1,1,1,1,1.29284129418165
-1,-1,-9,-3,3,3,4,1,10,7,10,8,5,4,2,4,7,63,0,1,1,1,0.609971780921114
0,1,0,0,0,1,1,5,5,3,3,0,0,3,3,3,4,37,0,1,1,1,0.854917799040963
1,1,-1,0,2,4,3,3,4,3,3,5,3,4,4,3,7,52,0,1,1,1,0.804480502366867
0,-1,0,-1,1,4,4,9,9,5,6,7,6,2,2,2,7,66,0,0,1,1,0.610217712314393
0,1,0,-1,-2,2,2,8,8,7,8,7,9,1,1,2,1,47,1,0,1,0,1.24757998896658
0,0,-2,-1,-1,3,3,5,7,8,9,8,9,4,4,3,5,66,0,0,1,0,0.999811302274783
0,0,1,-1,3,4,4,9,8,9,10,10,7,5,5,4,1,24,0,1,1,1,0.908179638404634
-2,-2,0,0,-5,1,3,0,0,0,0,0,5,3,2,4,4,45,0,1,0,0,1.12509666811802
0,0,-1,-2,1,3,3,3,4,1,3,6,5,1,2,1,1,40,0,0,0,1,0.881862966031092
0,0,2,2,1,2,2,4,2,2,0,6,5,2,1,3,5,50,1,1,1,1,0.811022465974532
-1,-1,0,3,2,1,2,1,1,5,2,5,3,1,1,1,1,50,0,1,0,1,1.12509666811802
0,0,-3,0,1,2,2,4,7,5,5,5,4,1,1,2,3,68,1,1,0,0,1.01296471611437
0,0,-1,-3,-1,2,2,4,5,2,5,3,4,3,1,3,4,64,0,1,1,0,0.99715685164954
1,1,-3,-1,-2,2,1,2,5,3,4,1,3,3,1,1,1,18,0,1,0,0,1.1192292675949
0,0,-4,-4,2,4,4,4,8,4,8,7,5,4,5,4,5,72,0,0,1,1,1.10608913571614
1,2,-1,0,-2,3,2,7,8,6,6,6,8,4,4,3,5,29,0,1,1,1,0.772358009178968
1,0,-4,6,5,3,2,4,8,7,1,7,2,2,1,1,5,53,0,1,0,1,1.27404636955291
0,0,-2,-2,-1,1,1,0,2,0,2,2,3,5,4,4,6,42,0,1,0,0,0.831439784730968
0,1,-1,0,2,2,2,5,6,3,3,7,5,3,3,3,6,41,1,0,1,0,0.69342567367563
2,0,-2,-4,-3,4,2,4,6,3,7,2,5,3,3,1,4,33,1,1,1,1,1.09396718669245
0,0,-2,-1,1,3,3,2,4,5,6,8,7,2,4,3,5,74,0,0,1,1,0.899737616578061
-1,0,-2,0,-4,3,4,4,6,2,2,3,7,4,5,3,2,31,0,0,0,1,0.989742092934841
0,1,-1,0,1,2,2,4,5,5,5,5,4,1,1,3,1,34,1,1,0,0,1.28758050649316
0,1,-2,-3,2,3,3,5,7,4,7,9,7,1,4,3,7,67,1,0,1,1,1.03817088521266
1,2,-1,-2,3,2,1,5,6,4,6,5,2,3,1,3,2,55,0,0,1,1,0.947580451728752
-1,0,-3,-3,1,2,3,4,7,5,8,4,3,2,4,3,2,64,0,0,1,1,0.575886691723155
0,-1,0,0,0,4,4,8,8,8,8,8,8,2,4,3,1,37,1,0,1,1,1.39282395380352
0,0,0,0,-6,4,4,0,0,0,0,0,6,1,1,1,4,38,1,0,0,0,1.0271039297722
0,1,-2,0,0,2,2,2,4,0,0,1,1,1,1,1,1,51,0,0,1,0,0.623419715383113
0,0,1,0,0,4,4,9,8,6,6,8,8,4,4,4,1,35,1,0,1,1,1.40468754804547
0,1,-1,1,2,2,2,7,8,7,6,7,5,1,2,1,2,66,0,1,1,1,0.668703136772652
0,0,-1,-1,-1,3,3,8,9,8,9,5,6,4,4,2,6,60,0,1,1,1,0.950088329255838
0,0,-3,-5,0,2,2,3,6,0,5,7,7,1,1,3,3,41,1,1,1,1,0.803895866194642
0,0,-1,-2,1,4,4,0,1,0,2,5,4,4,5,4,5,40,1,0,1,1,1.19801118384997
-1,0,-1,-1,1,2,3,6,7,3,4,8,7,3,2,4,6,58,0,1,1,1,0.923449497630448
1,1,0,0,0,4,3,8,8,8,8,8,8,5,1,4,1,19,0,0,1,0,0.944454639294945
0,0,-3,0,-1,4,4,3,6,2,2,8,9,5,4,3,5,70,1,0,1,1,1.15957416723969
0,0,-2,-1,-2,4,4,1,3,5,6,3,5,4,2,3,6,57,1,0,1,1,1.0889256746552
1,1,-5,-5,-3,2,1,0,5,1,6,0,3,2,1,3,3,44,0,0,0,1,0.706246784765346
0,0,0,1,2,2,2,5,5,4,3,5,3,1,1,1,1,45,1,1,1,0,0.789878963580859
0,1,2,1,-1,2,2,2,0,4,3,3,4,3,5,1,7,52,0,1,1,1,1.12509666811802
0,0,-4,-4,-3,4,4,1,5,3,7,6,9,4,4,4,7,68,0,1,1,1,1.10127077795352
-1,0,0,-1,-1,2,3,5,5,3,4,2,3,3,2,3,2,73,0,1,1,1,0.701611082007767
0,0,-2,-1,-1,2,2,2,4,3,4,2,3,5,2,2,7,45,0,1,1,0,1.10093280448241
-2,1,-3,-2,-2,1,3,3,6,4,6,3,5,2,2,4,4,69,1,1,1,0,1.22722337439593
2,1,0,2,5,4,2,5,5,5,3,7,2,2,2,4,2,56,0,0,1,1,0.943724588215773
-2,-2,-6,-5,-5,2,4,2,8,2,7,2,7,1,4,3,1,60,0,1,0,1,0.923449497630448
0,2,0,1,1,2,2,3,3,3,2,9,8,2,1,1,7,60,1,1,1,1,1.07992394658632
1,1,-4,-4,-1,3,2,2,6,2,6,5,6,5,4,4,6,65,1,1,0,0,0.868396331719577
0,0,-5,-7,-5,2,2,2,7,1,8,1,6,4,5,4,4,54,0,0,0,0,0.931619683860887
-1,-1,0,0,1,1,2,0,0,0,0,3,2,1,1,1,3,35,0,1,0,0,0.697145939323526
0,0,0,0,0,2,2,0,0,0,0,0,0,3,3,2,4,33,0,0,1,0,0.77761125953148
0,0,0,1,2,2,2,6,6,4,3,6,4,4,1,3,6,28,0,1,0,0,0.921510937919353
1,0,1,2,0,3,2,6,5,7,5,4,4,3,1,3,1,19,0,1,0,0,1.07754704306469
0,0,0,0,0,3,3,5,5,0,0,3,3,3,5,3,7,37,0,1,1,1,1.05096423118238
1,0,5,0,0,4,3,10,5,3,3,5,5,4,2,3,1,55,0,0,1,0,0.864371645657888
-1,1,-1,-1,-1,2,3,7,8,8,9,8,9,4,2,3,6,30,1,0,1,1,0.86893720456905
0,0,0,0,0,4,4,10,10,10,10,10,10,4,5,3,7,56,0,1,0,0,1.4518089251083
0,2,-2,-2,-3,2,2,5,7,6,8,5,8,4,5,3,4,63,0,0,1,1,0.614647624631183
0,0,0,0,0,4,4,0,0,0,0,10,10,1,1,1,4,46,0,0,1,1,0.712507601261646
0,0,2,-3,1,2,2,6,4,2,5,5,4,4,1,3,5,19,0,1,1,0,0.755621983698974
-1,-1,-5,0,-2,2,3,0,5,0,0,3,5,4,1,4,7,49,0,1,0,1,0.840509038434814
-1,-1,0,0,-1,2,3,0,0,0,0,0,1,3,1,2,4,29,0,0,0,0,0.688891550076922
0,0,0,0,0,3,3,0,0,5,5,5,5,3,5,3,6,46,0,1,1,1,0.886301172363772
-1,-2,-4,-1,-5,3,4,1,5,1,2,3,8,4,5,3,4,43,0,0,1,0,0.74607001129262
-1,-1,-5,-5,-2,3,4,4,9,4,9,4,6,4,5,4,4,61,0,1,1,0,0.610360777532627
0,-1,0,0,-2,2,2,3,3,2,2,2,4,1,4,4,5,62,0,1,0,0,1.08621796451903
-1,-1,-3,-3,0,2,3,5,8,5,8,5,5,3,2,4,4,59,0,0,0,1,0.541328259223347
1,2,0,2,1,3,2,5,5,6,4,6,5,3,3,1,4,53,0,0,1,1,1.02941922157051
0,2,-1,2,-3,2,2,6,7,8,6,5,8,5,4,2,7,29,0,0,1,0,1.06953754455651
0,0,0,-3,-3,1,1,0,0,0,3,0,3,3,4,4,4,58,0,1,0,0,0.680207872989352
1,1,-2,-2,1,3,2,3,5,2,4,4,3,4,2,3,7,34,0,1,1,1,0.622136985755584
1,1,1,1,1,2,1,4,3,4,3,5,4,3,1,3,5,18,0,1,0,0,2.17524724822655
0,0,-3,-3,-4,3,3,1,4,1,4,2,6,1,1,3,4,65,0,1,0,1,0.726059563304626
-3,-3,0,0,0,1,4,0,0,0,0,0,0,3,3,2,4,58,0,1,0,1,0.99715685164954
1,0,-1,0,0,4,3,4,5,6,6,5,5,2,4,1,7,53,0,1,0,0,1.00730305735456
0,0,-2,-2,-2,3,3,5,7,5,7,5,7,3,4,4,2,55,0,0,1,0,0.620543769508439
-1,-1,-1,1,0,3,4,3,4,3,2,1,1,5,1,3,3,32,0,1,1,1,1.04577979811021
1,2,2,-1,1,2,1,2,0,0,1,5,4,3,1,1,4,25,0,1,1,1,0.992838146665338
1,1,-4,-4,-5,3,2,2,6,3,7,2,7,4,5,3,7,56,0,1,1,1,1.03143730714755
1,1,4,2,2,3,2,7,3,6,4,5,3,1,5,3,7,35,0,1,1,0,0.6952937592547
-1,-3,-3,-3,-3,3,4,3,6,2,5,3,6,3,4,3,7,54,0,1,1,1,1.12808240178319
0,0,-3,-3,2,1,1,0,3,0,3,6,4,4,2,4,7,53,0,1,1,1,0.665784408216724
1,1,2,4,2,2,1,6,4,9,5,5,3,2,1,3,3,21,0,1,0,0,1.35172704765725
0,0,0,-1,-1,2,2,3,3,1,2,2,3,3,1,2,4,39,0,1,1,0,0.677167325179359
1,0,0,1,-1,4,3,5,5,5,4,4,5,4,1,3,1,49,0,0,0,0,1.08122339178616
0,0,-3,-1,0,2,2,1,4,1,2,5,5,4,3,2,6,53,0,0,1,1,0.607554258586838
0,0,-1,-1,-2,2,2,3,4,3,4,3,5,3,1,3,3,33,0,1,1,1,0.992838146665338
0,-1,-1,1,-2,3,3,3,4,2,1,1,3,5,4,4,7,33,0,1,0,1,1.02515984705531
0,0,-2,0,0,3,3,5,7,5,5,5,5,3,1,2,1,32,0,1,0,0,0.747744447555335
0,0,-2,0,0,3,3,3,5,4,4,5,5,1,1,2,2,36,0,1,0,0,0.902029148157918
0,0,-2,-2,0,2,2,3,5,2,4,3,3,3,1,2,2,36,0,1,1,0,1.20587761041072
1,1,-2,-2,0,3,2,2,4,0,2,3,3,3,4,3,7,67,0,1,1,0,0.686106077106104
1,2,-1,0,1,3,2,6,7,5,5,6,5,3,5,3,6,37,0,0,1,0,0.981861753607919
1,2,0,1,0,2,1,0,0,1,0,4,4,3,1,2,4,32,0,1,0,0,0.818741790510722
0,1,-1,-1,5,3,3,1,2,1,2,7,2,2,4,4,1,54,0,1,1,0,1.12808240178319
-1,-1,0,0,0,2,3,10,10,10,10,10,10,5,1,4,4,19,0,0,1,0,1.15907158996498
0,0,3,0,-5,2,2,5,2,1,1,2,7,3,5,4,7,53,0,1,1,1,1.1575524340058
-1,-1,-3,-2,-3,2,3,2,5,3,5,4,7,2,1,3,3,27,0,1,0,1,0.622136985755584
3,3,5,-2,0,4,1,5,0,0,2,0,0,4,1,4,1,49,0,1,0,0,0.886301172363772
1,2,2,2,-4,3,2,6,4,7,5,0,4,1,5,3,6,32,0,1,0,0,0.640083827953232
1,0,-1,-1,1,3,2,5,6,4,5,6,5,2,5,2,1,36,0,1,0,0,0.817576000721432
-2,-2,-8,-9,-7,2,4,2,10,0,9,0,7,1,1,3,1,37,0,1,1,1,1.07596685783587
-2,-2,-8,-7,-5,1,3,0,8,0,7,2,7,4,4,3,5,48,0,0,1,0,0.733061372822
0,0,-3,-4,-4,3,3,2,5,0,4,2,6,4,4,3,6,74,0,0,1,1,0.899737616578061
-1,1,-4,-5,-2,2,3,3,7,2,7,7,9,1,1,4,2,63,0,0,1,1,0.884431277465904
0,-2,0,1,1,4,4,10,10,10,9,10,9,5,5,4,7,41,0,1,1,1,0.817576000721432
-1,-1,0,-2,0,2,3,9,9,7,9,9,9,4,1,2,6,25,0,1,0,1,1.02515984705531
0,0,-3,-1,-5,1,1,2,5,0,1,0,5,3,2,3,4,26,0,0,0,0,0.840914698148064
0,0,1,-2,-1,2,2,3,2,3,5,2,3,3,1,2,4,32,0,0,0,0,0.704806829116349
0,-1,0,0,0,4,4,0,0,0,0,2,2,3,2,3,4,73,0,0,1,0,0.871866766783756
0,0,-2,-2,0,2,2,3,5,3,5,7,7,4,4,3,5,47,0,0,0,0,0.672968050258257
-1,1,-7,-5,-4,2,3,0,7,0,5,2,6,1,5,4,6,36,0,1,1,1,0.747757898437951
-1,-1,0,0,2,3,4,5,5,2,2,4,2,3,5,4,2,63,0,1,1,1,0.950088329255838
1,1,-2,-3,-1,3,2,5,7,3,6,6,7,1,1,3,1,56,0,1,1,1,1.05576229363635
0,0,0,0,0,3,3,7,7,5,5,5,5,3,1,3,1,55,0,0,0,0,0.763357175542007
-1,-1,-1,-2,-2,2,3,4,5,3,5,3,5,1,1,2,2,50,0,0,1,1,0.786107498330382
0,1,0,0,0,3,3,0,0,0,0,2,2,3,3,3,6,61,0,1,0,0,0.593211074771015
0,1,-1,-1,-4,3,3,7,8,8,9,3,7,5,4,3,7,48,0,1,0,0,1.27404636955291
-1,-2,-5,-5,-5,3,4,3,8,2,7,3,8,5,4,4,7,61,0,1,1,1,0.923449497630448
0,1,-2,0,-3,1,1,6,8,1,1,1,4,3,4,4,4,55,0,0,0,0,0.91726418487
0,0,0,-3,0,3,3,7,7,7,10,10,10,2,5,3,1,31,0,1,0,0,1.12044939923586
0,0,-3,3,-3,2,2,4,7,7,4,3,6,1,1,1,1,28,0,1,1,0,0.996416140061024
0,0,0,1,0,2,2,3,3,3,2,3,3,2,1,3,2,49,0,1,1,1,1.18485166695204
0,0,0,0,1,3,3,2,2,2,2,8,7,1,4,4,2,68,0,0,1,1,0.709245266500731
1,1,-1,0,4,3,2,3,4,6,6,8,4,1,1,1,4,71,0,1,1,0,1.04314200355664
0,-1,0,0,1,2,2,0,0,0,0,5,4,3,3,4,4,64,0,1,0,1,0.725211308071736
0,0,1,-2,0,4,4,7,6,6,8,5,5,4,3,2,7,52,0,1,0,0,0.886301172363772
0,0,-1,-3,-1,2,2,7,8,3,6,6,7,2,1,2,6,59,0,0,1,0,1.06583427201199
1,1,4,2,-4,3,2,6,2,6,4,1,5,1,1,1,1,26,0,0,1,0,0.584101475982541
0,0,-6,-5,0,3,3,0,6,2,7,7,7,5,4,4,5,54,0,0,1,1,0.712507601261646
0,0,1,1,2,3,3,7,6,6,5,7,5,1,3,3,1,25,0,0,1,1,0.665694621024762
1,0,-3,-1,-1,4,3,0,3,3,4,4,5,4,2,3,7,55,0,0,1,1,0.91726418487
1,0,-3,-2,-4,3,2,3,6,2,4,1,5,2,1,3,1,51,0,1,0,0,1.46459047537333
1,1,4,1,-1,2,1,4,0,3,2,0,1,3,1,2,4,18,0,1,0,0,0.799894638387298
1,1,-1,-1,0,4,3,2,3,3,4,5,5,4,4,4,5,56,0,0,1,0,0.779335284058457
-2,0,-1,0,1,2,4,5,6,7,7,6,5,3,5,1,1,37,0,1,0,0,0.65856023070912
1,1,0,0,0,3,2,7,7,7,7,4,4,3,1,2,1,38,0,1,0,0,1.1780939352812
-1,-1,-5,-4,-2,2,3,2,7,2,6,7,9,1,1,3,1,56,0,1,1,1,0.69713804491444
1,1,1,-1,-3,3,2,7,6,5,6,5,8,1,4,2,6,78,0,0,1,0,0.54602221337156
0,0,2,0,2,2,2,8,6,7,7,6,4,4,4,3,6,30,0,1,1,1,0.831424828554684
0,0,0,-3,1,1,1,6,6,3,6,4,3,4,2,2,7,48,0,1,1,1,0.768883845169354
-1,-1,-4,-3,-1,2,3,1,5,1,4,6,7,2,5,4,5,33,0,1,1,1,0.658168886388622
1,0,-1,0,-2,3,2,5,6,5,5,5,7,1,1,3,1,49,0,1,1,1,0.628934501007348
-1,1,0,0,0,1,2,0,0,0,0,4,4,2,2,4,4,81,0,1,1,1,0.958326715074967
2,2,3,0,6,3,1,5,2,0,0,8,2,3,2,4,4,66,0,0,0,1,1.5026644676215
-1,-1,-2,0,-3,3,4,5,7,5,5,2,5,1,2,3,2,78,0,1,1,0,1.04314200355664
0,0,-2,2,1,4,4,1,3,9,7,2,1,3,5,4,3,42,0,0,1,1,1.05196754990932
0,-1,0,0,0,4,4,5,5,5,5,5,5,3,1,3,1,19,0,1,1,0,1.35172704765725
-1,-1,-3,-4,-5,2,3,4,7,2,6,3,8,2,1,3,2,44,0,1,1,0,1.17206689025408
1,-2,-2,0,-2,4,3,3,5,1,1,5,7,5,5,4,7,59,0,1,0,1,1.03839991469962
-1,1,-1,1,1,2,3,7,8,7,6,8,7,4,2,3,7,53,0,0,1,0,0.945719698448648
-1,0,9,0,-3,3,4,10,1,8,8,2,5,4,4,3,4,64,0,0,1,1,0.686470696824433
-1,-1,-3,-2,-2,2,3,2,5,3,5,3,5,3,2,3,1,46,0,0,1,1,1.05631177621218
1,2,0,-5,-7,3,2,1,1,2,7,3,10,2,5,4,7,52,0,1,1,0,1.15163047784248
0,0,-1,0,-3,4,4,0,1,2,2,0,3,1,1,1,1,52,0,0,0,1,0.866486612160693
-1,-1,0,-5,4,2,3,4,4,2,7,6,2,3,5,3,6,73,0,1,0,0,1.10127077795352
0,-1,-2,-3,0,3,3,1,3,2,5,7,7,5,2,3,6,61,0,0,1,1,0.963424300175819
0,0,7,-6,0,4,4,7,0,0,6,6,6,4,4,3,6,33,0,0,0,0,0.618324571004903
-1,2,-5,-5,-6,1,2,0,5,0,5,0,6,1,1,3,1,44,0,1,0,1,1.14506222126633
0,0,0,0,-1,2,2,5,5,5,5,6,7,3,1,2,3,23,0,0,0,0,1.20210002095521
0,0,0,0,1,2,2,8,8,7,7,7,6,3,1,4,1,66,0,0,1,1,1.53564575325297
-1,0,-4,6,4,3,4,1,5,8,2,8,4,1,5,1,1,52,0,1,0,0,1.31079890102165
0,0,-2,-2,-2,1,1,0,2,1,3,0,2,1,1,2,2,52,0,0,0,0,1.05575797282827
0,0,-1,-1,1,3,3,6,7,6,7,8,7,3,5,3,7,20,0,1,0,0,1.27016111186612
-1,0,0,-4,-3,2,3,0,0,1,5,1,4,1,5,3,7,39,0,0,0,1,1.05196754990932
1,1,0,0,-1,4,3,2,2,3,3,3,4,4,5,2,6,65,0,0,1,1,1.00495256834718
0,1,0,1,2,3,3,2,2,7,6,6,4,4,4,4,5,70,0,0,0,0,0.677864585039849
-1,-3,-3,0,-4,3,4,3,6,1,1,1,5,2,4,4,2,72,0,1,0,0,0.701611082007767
-1,-1,0,0,-1,2,3,5,5,3,3,7,8,1,1,2,2,74,0,0,1,1,1.00495256834718
0,0,-6,-7,-2,4,4,0,6,0,7,4,6,4,4,3,4,49,0,1,1,1,0.721170283857166
0,0,0,0,-2,3,3,4,4,5,5,4,6,4,4,3,6,60,0,0,1,1,0.921011936646702
0,0,0,0,0,2,2,1,1,3,3,3,3,1,1,3,1,51,0,1,0,1,0.684553791866173
0,0,0,-2,-2,3,3,6,6,5,7,5,7,2,2,2,5,67,0,1,1,1,1.0058033770442
-2,-3,-3,-5,-5,2,4,3,6,3,8,2,7,4,1,3,6,82,0,1,1,0,1.0919075147224
0,0,0,0,0,4,4,10,10,10,10,10,10,1,1,1,1,67,0,0,1,0,0.610217712314393
0,0,-7,-6,0,1,1,0,7,0,6,0,0,1,4,2,6,39,0,1,0,0,0.794652585336216
-1,0,0,0,-2,2,3,0,0,0,0,1,3,4,1,4,5,45,0,0,0,0,0.712507601261646
0,0,0,-2,0,4,4,4,4,4,6,5,5,3,4,2,2,72,0,1,1,0,1.07761862640208
-1,-1,-2,1,-5,3,4,3,5,4,3,2,7,3,1,4,7,51,0,1,0,1,1.27404636955291
1,0,0,0,-1,3,2,2,2,3,3,3,4,4,4,3,4,32,0,0,0,0,1.01559812200219
0,0,-1,0,2,2,2,1,2,3,3,5,3,3,4,3,6,24,0,1,0,1,1.00921634739575
2,1,4,2,1,3,1,4,0,2,0,1,0,3,5,1,7,24,0,1,0,1,1.5306799731039
0,-1,0,1,2,4,4,7,7,8,7,8,6,4,2,3,6,50,0,1,1,0,1.27404636955291
-1,-1,-6,-4,-2,2,3,2,8,4,8,6,8,5,4,4,7,76,0,0,1,1,0.698426026578385
0,1,-1,1,0,2,2,1,2,5,4,2,2,5,2,3,5,31,0,1,0,0,0.830932436971272
1,1,4,1,2,3,2,7,3,4,3,4,2,1,2,2,2,79,0,1,1,0,0.633413132439133
-1,-1,-1,-1,-1,2,3,3,4,3,4,3,4,4,4,4,6,53,0,1,0,0,1.81054557985967
-3,0,-3,4,-5,1,4,0,3,6,2,5,10,3,3,1,4,30,0,0,1,0,1.04434735548898
-1,-1,0,-2,0,1,2,6,6,5,7,6,6,1,1,1,2,48,0,0,1,1,0.964741799196824
0,0,2,0,0,1,1,2,0,0,0,0,0,4,2,3,4,43,0,0,0,0,1.06955678404937
1,1,-1,-7,-5,3,2,8,9,2,9,3,8,4,5,4,6,60,0,1,0,0,1.03839991469962
1,-2,-4,-4,-5,4,3,0,4,1,5,0,5,4,5,4,7,74,0,1,1,1,0.677356891839579
0,1,1,0,-2,2,2,4,3,2,2,0,2,4,1,3,3,23,0,1,0,1,0.981500939116013
2,-1,0,-3,-2,4,2,8,8,3,6,1,3,5,5,4,7,53,0,1,1,1,1.27404636955291
1,1,2,0,2,4,3,4,2,1,1,3,1,3,4,4,2,68,0,1,0,0,0.911851611143564
0,0,0,0,0,2,2,5,5,5,5,5,5,1,1,3,3,37,0,0,0,1,0.682358267903501
0,-1,-5,-5,-2,2,2,3,8,2,7,1,3,4,4,3,2,65,0,1,0,0,0.868114057715094
0,0,-5,-4,-2,3,3,1,6,1,5,5,7,1,1,1,1,65,0,0,1,1,0.577645824547387
0,1,0,0,1,2,2,8,8,6,6,8,7,1,1,2,1,85,0,1,1,0,0.701611082007767
0,0,-3,-3,-3,4,4,6,9,5,8,6,9,4,5,4,7,54,0,0,0,1,0.874625581910835
0,0,1,0,0,1,1,2,1,0,0,0,0,3,1,2,4,36,0,0,0,0,1.21738168977492
1,2,0,-1,0,3,2,8,8,8,9,8,8,5,4,4,7,44,0,1,1,0,1.20587761041072
-2,0,-3,-3,0,1,3,0,3,0,3,0,0,3,4,3,4,42,0,1,0,1,1.06461432813572
-1,0,-6,-5,1,2,3,3,9,1,6,5,4,1,2,4,1,67,0,1,1,1,0.633009444044864
0,0,-3,-5,-1,1,1,4,7,1,6,6,7,4,1,4,7,39,0,1,1,1,0.876737812753563
1,1,0,-2,1,3,2,5,5,2,4,4,3,4,4,4,4,82,0,1,1,0,0.651269925035392
-1,-2,-2,-4,-7,2,3,5,7,2,6,0,7,3,3,4,4,53,0,1,0,0,0.70287794709029
1,1,0,-5,-3,4,3,5,5,2,7,6,9,3,1,4,3,76,0,1,0,0,1.10127077795352
-1,-1,-1,0,0,2,3,0,1,0,0,7,7,2,5,4,2,65,0,0,1,1,0.853349195422308
1,1,-2,3,-3,2,1,4,6,3,0,0,3,3,4,1,3,19,0,1,0,0,1.27016111186612
-1,-1,-2,-2,-2,1,2,2,4,0,2,0,2,3,2,4,4,40,0,1,0,0,1.1780939352812
0,0,10,10,10,4,4,10,0,10,0,10,0,3,3,1,7,41,0,1,0,0,1.15279184168449
-1,-1,0,0,0,2,3,1,1,2,2,2,2,2,2,2,4,53,0,1,1,0,0.782377983748184
0,-2,-1,0,0,4,4,7,8,3,3,5,5,4,5,3,6,45,0,1,1,1,0.778949513031145
0,0,-1,0,1,3,3,3,4,2,2,4,3,3,1,3,6,24,0,1,1,0,0.938074257573367
0,0,-3,-2,5,3,3,3,6,2,4,8,3,2,4,3,5,76,0,0,1,1,0.824356942655554
0,0,0,0,0,1,1,0,0,0,0,0,0,3,1,1,4,54,0,0,0,0,1.08122339178616
0,1,0,-1,0,3,3,1,1,7,8,2,2,4,4,3,6,69,0,0,1,1,0.999811302274783
0,-2,-8,0,-2,4,4,0,8,2,2,0,2,1,1,3,4,79,0,1,0,0,1.07039305224686
-1,-1,-3,-2,-3,1,2,2,5,2,4,2,5,2,2,4,7,78,0,1,1,1,1.21210063175364
-1,-1,0,0,-4,1,2,1,1,3,3,0,4,4,3,4,7,79,0,1,1,1,0.658364977470791
2,2,2,5,-7,3,1,2,0,7,2,1,8,1,1,2,3,52,0,1,0,0,0.768883845169354
1,2,-3,-4,2,2,1,1,4,1,5,7,5,1,1,1,1,53,0,0,1,0,0.85010259505336
-1,-1,0,-3,-6,1,2,0,0,5,8,2,8,4,4,4,7,74,0,1,1,0,1.21210063175364
-1,1,1,0,0,2,3,6,5,5,5,5,5,2,4,3,2,49,0,1,0,0,1.18485166695204
-2,-2,-3,-2,6,1,3,0,3,2,4,6,0,4,2,3,6,49,0,1,1,1,0.886301172363772
0,1,-3,1,-1,3,3,0,3,5,4,2,3,4,5,3,7,24,0,1,1,1,1.57483563746942
3,3,-2,-2,6,4,1,3,5,0,2,10,4,3,5,3,4,44,0,0,0,0,0.981861753607919
0,0,0,0,2,4,4,10,10,10,10,10,8,5,4,4,1,47,0,0,1,1,0.85010259505336
0,0,-3,1,0,4,4,4,7,10,9,9,9,5,5,3,1,49,0,1,1,0,1.13269151319873
1,1,-2,1,-2,2,1,2,4,2,1,3,5,1,1,1,3,23,0,0,0,0,1.19250743351255
1,2,2,1,1,3,2,6,4,5,4,4,3,3,5,2,1,42,0,1,0,0,1.20587761041072
0,0,-1,-1,0,1,1,0,1,1,2,1,1,5,1,4,4,60,0,1,1,1,0.752264477096167
1,1,-2,-1,5,2,1,1,3,5,6,8,3,5,5,4,7,24,0,1,0,1,1.38360561356033
0,2,7,10,-7,2,2,9,2,10,0,2,9,2,5,4,4,21,0,1,1,1,1.34312481735815
-1,-2,0,0,1,2,3,2,2,2,2,1,0,3,1,4,4,NA,0,1,0,0,1.34312481735815
0,0,-1,2,0,2,2,3,4,5,3,5,5,5,1,4,6,19,0,1,1,0,1.42351861050294
1,1,-3,-4,-4,3,2,2,5,0,4,0,4,3,4,2,3,35,0,0,1,1,0.780608156356673
0,0,0,1,0,4,4,4,4,9,8,3,3,5,5,1,7,39,0,1,1,1,1.02922890177425
-2,-3,-7,-5,-7,2,4,0,7,2,7,0,7,1,1,2,3,62,0,1,0,0,0.610360777532627
0,1,1,1,0,2,2,2,1,2,1,2,2,3,1,1,4,22,0,1,1,1,1.38360561356033
-1,1,1,0,-7,2,3,3,2,2,2,0,7,3,3,4,2,42,0,1,0,0,0.975461144043869
0,0,-3,0,-2,3,3,2,5,1,1,1,3,4,2,4,3,23,0,1,0,0,1.17370892577185
1,1,-4,3,-2,2,1,1,5,4,1,4,6,1,1,1,1,19,0,1,0,0,1.30340158708787
0,1,-1,0,0,3,3,7,8,8,8,9,9,4,4,4,6,64,0,1,0,0,1.08621796451903
3,3,0,-1,-1,4,1,4,4,4,5,4,5,4,4,3,4,18,0,0,1,0,2.19599911953117
1,2,0,1,0,3,2,8,8,7,6,8,8,3,1,2,4,44,0,1,0,1,0.817576000721432
-1,-1,-2,-1,0,2,3,3,5,3,4,5,5,1,1,1,3,43,0,0,0,0,1.06955678404937
0,0,0,0,1,3,3,7,7,7,7,5,4,3,2,3,5,35,0,0,0,0,1.06955678404937
1,1,4,5,3,3,2,6,2,6,1,7,4,2,1,1,3,21,0,1,0,0,1.34100093118605
1,1,0,2,-2,3,2,0,0,7,5,5,7,1,1,1,1,56,0,0,1,1,0.907577093921231
-1,0,-4,-6,-4,2,3,0,4,0,6,3,7,3,1,3,4,56,0,0,1,1,0.794355403630684
0,0,-7,-7,2,4,4,1,8,1,8,8,6,5,5,3,7,64,0,0,1,1,0.643228357273556
-1,0,-3,-3,-3,2,3,5,8,5,8,5,8,3,4,4,6,57,0,0,1,0,0.683433086800297
3,1,0,-1,0,4,1,6,6,6,7,6,6,5,4,3,3,18,0,0,1,0,0.750991581613018
0,1,0,0,0,2,2,4,4,5,5,2,2,1,1,3,3,58,0,0,0,0,0.741456659196172
-1,0,-3,-1,-1,1,2,3,6,2,3,5,6,4,4,3,3,63,0,0,1,0,0.81727024618822
0,0,0,-2,2,4,4,10,10,8,10,8,6,5,5,4,7,43,0,0,1,1,0.642693598020306
-2,-2,-5,-7,-6,1,3,0,5,0,7,0,6,1,1,2,1,55,0,0,0,1,0.620543769508439
-1,0,-2,2,-1,3,4,8,10,9,7,9,10,2,2,1,7,42,0,0,1,0,1.00915312917683
0,0,-3,-6,-3,4,4,5,8,1,7,4,7,5,4,4,7,43,0,0,1,1,0.618335693803943
2,1,-2,4,0,3,1,0,2,7,3,0,0,1,1,1,3,20,0,0,0,0,0.899638787439129
0,0,-5,-4,-5,1,1,0,5,0,4,0,5,3,5,4,7,73,0,0,1,1,0.969024608038976
1,1,-5,-4,0,3,2,2,7,3,7,3,3,4,4,3,5,54,0,0,1,0,0.689801356822485
0,0,0,0,0,2,2,6,6,7,7,9,9,2,2,2,6,79,1,0,1,1,0.680391388143647
0,0,-4,-2,1,3,3,2,6,5,7,8,7,1,1,1,1,65,1,0,1,0,0.858440697797733
0,0,0,0,0,2,2,2,2,2,2,8,8,5,1,2,7,66,1,0,1,1,0.970366054592694
-1,0,-1,-2,-1,2,3,4,5,4,6,3,4,4,2,3,2,48,0,0,1,1,0.922835248364614
0,0,0,-1,0,4,4,10,10,8,9,10,10,5,4,4,1,24,0,0,1,1,0.92149504103127
1,1,1,1,-2,4,3,8,7,9,8,7,9,4,4,4,7,36,0,0,1,0,0.734686850527565
0,0,-1,0,-3,3,3,3,4,0,0,2,5,2,2,4,2,52,0,0,1,1,0.76699730330058
0,0,0,0,0,4,4,10,10,10,10,10,10,5,1,4,1,37,1,0,0,1,1.25471013049728
0,1,-1,2,0,3,3,7,8,9,7,1,1,4,4,3,6,35,0,0,0,0,1.03826426125428
0,0,-1,0,1,3,3,5,6,7,7,5,4,4,2,2,6,72,1,0,0,0,0.680391388143647
0,0,-1,-3,-1,3,3,6,7,3,6,6,7,1,4,4,2,66,0,0,0,0,0.970559355642484
0,0,-6,-4,0,3,3,0,6,1,5,8,8,4,4,3,7,68,0,0,1,0,0.704728776409502
0,0,-1,-2,5,2,2,3,4,4,6,8,3,1,1,1,1,29,1,0,0,1,1.00893399229496
1,0,-2,1,0,2,1,0,2,2,1,4,4,1,1,2,4,77,1,0,0,0,0.680391388143647
-2,0,1,2,-1,2,4,8,7,8,6,8,9,5,5,4,1,32,1,0,1,1,0.868048318901438
-1,-1,-1,-1,-1,2,3,3,4,2,3,2,3,4,1,4,3,54,0,0,1,1,0.721876691316001
2,1,-7,1,-2,3,1,2,9,8,7,1,3,3,4,4,3,28,0,0,1,1,0.912861257964062
0,0,0,0,1,3,3,0,0,0,0,5,4,5,4,4,7,53,0,0,1,1,0.76699730330058
0,-1,0,-1,1,3,3,5,5,4,5,4,3,4,2,3,6,49,0,0,0,0,0.689801356822485
0,-1,0,0,0,4,4,5,5,5,5,5,5,1,1,3,1,45,0,0,0,1,0.922835248364614
-2,-3,-6,-6,-3,2,4,3,9,1,7,4,7,5,5,4,7,69,0,0,1,1,0.7297049291936
1,-1,-1,2,0,4,3,7,8,9,7,8,8,5,5,4,7,44,0,0,0,0,0.907302147198063
0,0,0,-5,-2,4,4,5,5,5,10,6,8,3,1,4,1,25,0,0,0,0,0.682345993448115
-1,-2,5,0,-2,2,3,7,2,0,0,4,6,2,1,3,5,28,0,0,0,1,1.06589713891453
-1,0,-5,-7,-1,2,3,3,8,0,7,3,4,5,5,4,7,19,0,0,0,0,1.22371569002828
1,1,0,0,0,3,2,5,5,5,5,5,5,4,4,3,6,19,0,0,0,1,0.828749367009778
0,-2,-7,-8,3,3,3,0,7,0,8,5,2,4,5,3,4,52,0,0,1,1,0.891482230249427
3,3,-5,0,0,4,1,0,5,5,5,5,5,2,5,4,7,19,0,0,0,0,1.10872372223138
0,1,-3,-2,-2,2,2,2,5,2,4,4,6,3,4,4,6,30,0,0,1,1,1.074473738613
-2,-2,-5,-3,0,1,3,0,5,0,3,3,3,3,2,4,4,42,0,0,1,0,0.780608156356673
0,0,1,0,4,2,2,2,1,1,1,6,2,3,3,4,7,54,0,0,1,1,1.0185476779212
-1,0,-4,-4,-3,2,3,0,4,3,7,6,9,4,1,2,5,33,0,0,1,1,0.682345993448115
1,1,1,1,-2,2,1,1,0,5,4,3,5,3,4,4,5,18,0,0,0,0,0.98034579351446
0,0,1,0,0,3,3,1,0,3,3,3,3,3,3,4,1,54,0,0,0,1,0.788655604951908
0,0,0,0,0,1,1,0,0,0,0,0,0,3,1,3,4,27,0,0,0,0,1.19210215854502
0,0,2,0,1,1,1,2,0,0,0,2,1,1,1,1,3,24,0,0,0,0,1.22371569002828
-1,1,-2,3,4,2,3,3,5,5,2,5,1,3,5,3,7,28,0,0,0,1,0.780131826252435
-1,1,3,-3,-3,2,3,8,5,4,7,5,8,2,5,3,4,29,0,0,0,1,1.62877380120602
-1,-1,-7,-6,-2,2,3,0,7,0,6,3,5,1,1,1,2,46,0,0,1,1,0.788655604951908
-1,-1,-2,-2,-3,3,4,2,4,5,7,3,6,5,4,3,7,39,0,0,0,0,1.68927334791655
0,0,2,0,0,2,2,5,3,2,2,3,3,4,4,4,2,43,0,0,0,0,1.58654861310694
0,-1,1,1,0,3,3,8,7,5,4,6,6,3,5,1,5,41,0,0,1,1,1.03826426125428
2,2,-2,-1,-3,3,1,3,5,8,9,5,8,3,2,2,5,18,0,0,0,0,1.99415929794632
2,3,0,-2,-6,3,1,5,5,7,9,2,8,3,1,1,3,39,0,0,1,0,1.03826426125428
-1,0,-5,-5,4,1,2,3,8,4,9,8,4,5,3,3,6,52,0,0,0,0,1.0185476779212
0,0,0,0,0,4,4,9,9,9,9,9,9,3,3,4,4,38,0,0,1,0,1.22651290077213
-2,-2,-2,-2,-2,1,3,3,5,0,2,2,4,1,1,2,2,35,0,0,0,1,1.10548906610333
2,3,3,3,5,3,1,4,1,5,2,8,3,1,1,4,1,33,0,0,1,0,1.074473738613
-1,0,0,0,-2,3,4,4,4,5,5,3,5,4,4,3,7,27,0,0,0,0,1.074473738613
0,0,-2,2,-3,3,3,5,7,9,7,5,8,1,1,2,6,46,0,0,1,1,0.922835248364614
-1,1,-1,0,0,1,2,1,2,1,1,4,4,3,3,1,4,47,0,1,0,0,1.80438299082525
0,0,0,2,1,3,3,3,3,4,2,3,2,3,2,3,1,42,0,0,0,1,0.890146366955661
-1,-1,-3,-5,-7,1,2,0,3,0,5,0,7,3,5,4,7,54,0,1,1,0,1.54531921206872
0,0,0,0,0,3,3,7,7,7,7,7,7,4,4,3,6,44,0,0,1,0,1.14005305380254
-3,-2,-1,-3,-6,1,4,7,8,3,6,2,8,3,1,4,7,66,0,1,0,0,0.705898241498511
-1,-1,-2,-2,-3,3,4,3,5,8,10,7,10,1,1,1,1,43,0,0,0,0,0.657770098315001
0,0,0,0,0,1,1,0,0,0,0,0,0,1,1,1,3,33,0,0,0,0,0.669762314773693
0,-1,0,0,-1,4,4,5,5,5,5,5,6,2,1,4,7,40,0,0,0,0,0.74607001129262
-1,-1,-2,-1,-5,2,3,5,7,2,3,1,6,2,2,3,1,22,0,0,1,0,1.30501159132528
1,0,1,1,0,3,2,6,5,6,5,6,6,3,1,3,4,27,0,0,0,0,1.10806800763227
0,2,0,-6,1,1,1,3,3,0,6,7,6,5,1,4,4,25,0,0,0,0,0.976924405602624
3,3,2,-7,-3,4,1,8,6,3,10,2,5,5,1,3,5,18,0,0,0,0,0.776486741523327
0,1,-3,-4,-1,2,2,5,8,0,4,8,9,2,2,2,3,33,0,0,1,1,0.639315863317906
1,2,-2,-2,1,3,2,4,6,4,6,6,5,4,1,3,5,32,0,0,0,1,0.723422804041811
0,0,0,3,2,4,4,6,6,7,4,8,6,5,2,3,6,31,0,0,0,1,1.074473738613
-3,0,0,4,1,1,4,1,1,7,3,3,2,2,4,4,4,41,0,0,1,0,0.689095404812922
0,-3,-1,-2,0,4,4,0,1,0,2,3,3,1,1,3,1,27,0,0,0,0,0.669762314773693
0,0,0,-2,2,2,2,3,3,1,3,5,3,3,3,4,7,18,0,0,0,0,1.6942161542765
0,0,-1,-1,0,2,2,2,3,1,2,3,3,4,1,3,4,43,0,0,0,1,1.0529914200105
-2,0,0,0,0,2,4,0,0,0,0,5,5,4,4,3,4,37,0,0,1,1,1.10548906610333
-1,-2,-7,-6,-5,2,3,0,7,0,6,0,5,4,4,4,6,36,0,0,1,0,1.0529914200105
0,0,-5,-5,-7,3,3,0,5,2,7,1,8,4,4,4,4,38,0,0,1,0,0.780608156356673
-1,-1,0,0,-1,2,3,6,6,7,7,6,7,4,1,1,1,30,0,0,0,0,0.584101475982541
-1,-1,-3,0,-2,3,4,2,5,2,2,4,6,4,2,4,6,33,0,0,1,1,0.584101475982541
1,-1,-1,1,0,4,3,4,5,6,5,4,4,4,2,2,4,41,0,0,0,0,0.600961914645819
1,2,-6,0,0,3,2,3,9,5,5,5,5,1,1,3,1,35,0,0,0,0,0.702042318903059
2,2,-3,-3,-3,4,2,5,8,6,9,5,8,3,4,4,5,39,0,0,0,0,0.708776816941185
-1,-1,-2,-3,-1,2,3,1,3,0,3,0,1,1,1,1,3,33,0,0,1,1,0.584101475982541
-1,-1,0,-1,1,2,3,0,0,0,1,3,2,2,2,2,4,21,0,0,0,0,1.084057569223
1,3,1,0,2,2,1,3,2,1,1,4,2,5,4,4,4,18,0,0,0,0,0.709425618583655
-1,-1,-3,-3,-3,2,3,3,6,1,4,1,4,1,1,1,3,30,0,0,0,0,1.04267779404867
-2,-2,-2,-3,-2,1,3,5,7,2,5,1,3,5,1,2,4,38,0,0,0,0,0.997507323521501
0,1,-1,-2,-2,2,2,3,4,4,6,5,7,4,1,3,3,19,0,0,0,0,1.2785417088331
0,0,-1,-4,-2,4,4,3,4,1,5,4,6,3,5,4,7,35,0,0,0,0,0.00996733808144198
-1,-2,-3,-2,0,2,3,5,8,1,3,7,7,4,4,3,7,18,0,0,0,0,1.27112986989642
-1,1,-4,-6,-6,1,2,3,7,2,8,2,8,2,1,1,3,24,0,0,0,0,1.32528005837508
0,1,1,-2,-1,3,3,6,5,4,6,5,6,5,2,2,1,20,0,0,0,0,0.831848897930556
1,1,0,2,0,4,3,5,5,7,5,5,5,3,3,3,2,21,0,0,0,0,1.52869005093927
-1,0,0,0,0,2,3,5,5,5,5,5,5,5,1,3,6,19,0,0,1,0,1.14684222197483
-1,0,-2,0,-2,2,3,4,6,4,4,3,5,3,1,3,4,18,0,0,0,0,1.27112986989642
1,1,2,-2,-2,3,2,5,3,3,5,2,4,3,3,1,4,35,0,0,0,0,1.07277531257068
0,0,-2,0,1,2,2,6,8,9,9,5,4,4,1,2,7,18,0,0,0,0,1.14757359636336
-1,-1,-1,-1,1,2,3,0,1,0,1,1,0,4,4,2,4,36,0,0,1,0,0.997507323521501
0,0,1,0,-2,2,2,8,7,5,5,7,9,4,1,2,5,18,0,0,0,0,1.40811615490541
-1,0,-2,-3,-4,2,3,4,6,1,4,3,7,1,1,2,2,22,0,0,0,0,0.880723330994972
1,1,0,0,1,3,2,3,3,3,3,7,6,4,4,3,7,18,0,0,1,0,1.48483233593902
1,2,0,-2,0,3,2,1,1,4,6,7,7,4,1,2,3,18,0,0,0,0,1.48483233593902
0,-2,1,-1,1,3,3,3,2,2,3,1,0,3,5,2,5,39,0,0,0,0,1.13735572888027
-2,-1,1,0,0,1,3,7,6,3,3,6,6,3,1,2,1,24,0,0,1,0,0.776486741523327
0,0,2,0,-3,1,1,2,0,0,0,2,5,4,2,3,6,42,0,0,0,0,0.907302147198063
2,3,2,3,2,3,1,3,1,4,1,2,0,1,1,2,6,20,0,0,0,0,1.99415929794632
-2,-2,-5,-7,-6,1,3,3,8,1,8,0,6,5,4,4,5,44,0,0,0,0,0.972121682107237
1,3,-2,2,4,2,1,5,7,2,0,6,2,1,4,4,7,18,0,0,0,0,1.24303898682913
2,1,0,-5,-2,4,2,4,4,2,7,4,6,4,1,4,1,21,0,0,0,0,1.14757359636336
-2,-1,-2,-4,-2,1,3,3,5,0,4,5,7,1,1,2,5,35,0,0,0,0,0.972121682107237
1,1,-5,0,0,2,1,2,7,1,1,5,5,5,1,1,1,18,0,0,0,0,1.32528005837508
0,1,0,0,-1,3,3,5,5,6,6,5,6,4,4,3,7,18,0,0,0,0,0.776486741523327
-1,1,0,0,-5,2,3,5,5,3,3,5,10,3,5,4,4,24,0,0,0,0,1.44787823009369
0,1,-2,2,-4,2,2,6,8,5,3,4,8,1,1,2,1,18,0,0,0,0,1.40811615490541
-1,0,0,-1,-5,2,3,4,4,5,6,2,7,4,4,3,1,21,0,0,1,0,0.83669933075975
1,1,2,3,-2,3,2,2,0,3,0,2,4,3,3,3,6,18,0,0,0,0,0.83669933075975
2,2,-4,-6,-1,3,1,2,6,0,6,4,5,2,2,3,2,22,0,0,1,0,1.52869005093927
1,1,-1,2,2,3,2,7,8,6,4,7,5,3,4,4,6,18,0,0,0,0,1.34581380816572
2,2,4,4,2,4,2,7,3,7,3,6,4,2,1,4,6,18,0,0,0,0,1.98499801561761
1,2,0,0,0,2,1,0,0,0,0,0,0,3,3,2,4,52,0,0,0,0,1.33649597289628
-2,0,-3,-4,-4,1,3,2,5,1,5,3,7,4,5,4,6,26,0,0,0,0,1.56238901105574
0,0,0,0,-1,4,4,0,0,0,0,0,1,1,1,3,1,58,0,0,1,0,1.00015323890298
-1,0,-7,-8,-5,2,3,1,8,0,8,1,6,4,4,4,6,65,0,0,0,0,1.37486911667131
-1,-2,-4,-8,-6,3,4,1,5,0,8,0,6,4,5,4,7,63,0,0,0,0,0.82719171886824
-1,-1,-3,0,-2,1,2,0,3,0,0,1,3,1,4,4,6,52,0,0,1,0,1.51672696567917
-2,0,2,-2,-3,1,3,5,3,3,5,5,8,3,3,4,2,67,0,0,1,0,1.21052487068321
1,0,0,-2,-7,4,3,1,1,3,5,1,8,1,1,3,1,87,0,0,0,0,1.44298179189714
-1,-1,-2,-1,2,2,3,0,2,0,1,3,1,2,2,3,6,59,0,0,1,1,1.44797669302546
-1,-2,0,-2,0,3,4,6,6,4,6,5,5,4,4,4,2,56,0,0,1,1,0.898524332149525
-1,-1,0,-3,-2,3,4,4,4,6,9,8,10,4,2,3,6,21,0,0,0,0,1.15845716897831
0,0,0,1,0,3,3,2,2,7,6,5,5,1,5,1,1,52,0,0,0,1,1.57945979028122
-1,-1,-1,0,1,3,4,5,6,5,5,6,5,4,4,3,7,41,0,0,0,0,0.971502127158364
1,1,3,0,1,3,2,7,4,5,5,6,5,2,1,3,1,27,0,0,1,0,0.684897974287621
-1,-2,-3,-5,-8,2,3,3,6,3,8,1,9,4,4,4,2,40,0,0,0,0,0.918316586433964
-1,-1,-2,-1,-2,1,2,3,5,1,2,2,4,2,4,3,3,21,0,0,0,0,1.17754092694548
0,2,0,0,0,2,2,5,5,5,5,5,5,3,1,2,4,18,0,0,0,0,1.084057569223
-2,-2,1,-2,-3,2,4,2,1,4,6,1,4,5,5,4,2,70,0,0,0,0,1.37486911667131
0,0,-9,-9,-9,4,4,0,9,0,9,0,9,1,1,1,1,72,0,0,1,0,1.57186178106251
0,0,0,0,0,1,1,10,10,10,10,10,10,3,3,2,3,34,0,0,1,0,1.02245380882398
0,0,0,0,0,2,2,5,5,3,3,5,5,3,3,1,3,18,0,0,0,0,2.19599911953117
-1,0,1,-1,-2,2,3,5,4,4,5,5,7,4,5,3,7,27,0,0,1,0,0.944848076917012
-1,-1,-3,-2,-5,3,4,3,6,7,9,3,8,4,4,2,6,18,0,0,1,1,1.084057569223
0,0,-3,-2,-3,3,3,1,4,0,2,2,5,1,2,1,3,36,0,0,0,0,1.38642830830665
0,0,-1,1,1,2,2,2,3,3,2,3,2,3,1,1,2,18,0,0,0,0,2.19599911953117
-1,-1,-6,-8,-4,1,2,3,9,0,8,0,4,5,4,4,5,44,0,0,0,0,0.972121682107237
-1,0,1,1,1,2,3,1,0,1,0,5,4,2,1,1,3,18,0,0,0,0,2.19599911953117
1,2,2,2,-1,2,1,3,1,4,2,8,9,3,2,1,3,18,0,0,0,0,1.38663593185983
0,0,0,4,1,1,1,4,4,7,3,4,3,5,1,4,4,24,0,0,0,0,1.93926324160529
1,1,1,0,0,2,1,1,0,0,0,0,0,1,1,1,1,18,0,0,0,0,1.18393593045877
2,2,-2,-1,2,4,2,3,5,1,2,5,3,3,3,3,2,29,0,0,0,1,1.05267991410517
-1,-1,1,0,0,1,2,4,3,0,0,3,3,5,1,4,4,24,0,0,0,0,1.93926324160529
-2,-3,-5,-3,-2,2,4,2,7,4,7,0,2,4,1,1,3,22,0,0,0,0,0.774787708397388
-2,-2,-3,2,2,2,4,0,3,7,5,6,4,5,4,4,6,69,0,0,1,1,1.57186178106251
-3,-2,-5,-5,5,1,4,3,8,2,7,8,3,3,5,4,7,25,0,0,1,1,1.10806800763227
0,1,-4,-5,-5,2,2,1,5,2,7,3,8,5,4,4,7,74,0,0,1,0,0.594309226172178
0,1,0,0,0,2,2,0,0,0,0,1,1,3,5,4,5,67,0,0,0,0,0.908150760579054
1,0,-4,-4,-3,3,2,3,7,3,7,4,7,4,4,4,5,33,0,0,0,0,0.974786794181983
2,2,3,2,3,3,1,6,3,3,1,7,4,2,1,1,2,18,0,0,0,0,1.18653218533354
0,0,0,1,1,3,3,5,5,6,5,6,5,5,5,2,4,30,0,0,0,0,1.0911616636182
-1,-1,-3,-2,-2,2,3,4,7,2,4,1,3,4,1,3,3,37,0,0,0,0,0.780608156356673
-1,-1,-2,0,-2,1,2,1,3,0,0,2,4,4,2,3,2,30,0,0,0,0,0.584101475982541
-1,0,-1,-1,2,3,4,9,10,8,9,10,8,5,5,3,3,32,0,0,1,0,0.759484527472296
-1,-1,-4,5,-1,3,4,3,7,8,3,4,5,2,5,4,2,33,0,0,0,0,0.935498373233063
0,0,0,0,0,3,3,5,5,5,5,5,5,1,1,1,4,24,0,0,1,0,0.880723330994972
0,0,-3,-3,0,2,2,3,6,1,4,5,5,4,5,3,5,23,0,0,1,0,0.83669933075975
-1,1,-5,-4,-4,1,2,0,5,0,4,2,6,1,1,1,2,34,0,0,0,0,0.944848076917012
1,2,-1,-1,-1,3,2,3,4,5,6,7,8,1,5,1,3,22,0,0,0,0,0.770602709876955
-1,-1,-1,0,-1,2,3,3,4,4,4,4,5,3,1,3,4,37,0,0,1,1,0.823136804601179
0,0,0,0,0,2,2,0,0,0,0,3,3,3,4,3,4,36,0,0,1,1,1.10041038585131
0,-2,-1,-2,0,3,3,6,7,3,5,7,7,3,1,3,2,19,0,0,0,0,1.29901629313486
0,1,0,0,1,2,2,8,8,8,8,9,8,5,5,1,7,22,0,0,0,1,1.29901629313486
0,0,0,0,0,4,4,5,5,5,5,5,5,1,1,2,3,34,0,0,1,0,0.617930498889213
0,0,-1,-2,-2,2,2,5,6,5,7,3,5,3,1,3,1,31,0,0,0,0,0.584101475982541
0,0,0,-2,1,3,3,1,1,3,5,4,3,2,4,3,1,27,0,0,0,0,1.04267779404867
-1,-2,-2,-2,-2,3,4,6,8,2,4,5,7,3,4,3,1,21,0,0,0,0,0.709425618583655
0,-1,0,0,-2,3,3,3,3,3,3,3,5,2,1,3,2,35,0,0,1,1,0.600961914645819
0,1,2,0,0,2,2,3,1,2,2,4,4,3,1,2,4,25,0,0,1,1,0.944848076917012
0,0,1,-2,-2,3,3,1,0,1,3,2,4,1,1,1,3,26,0,0,1,0,0.865172640908077
-2,-2,-3,-1,-1,2,4,0,3,5,6,4,5,2,1,2,3,24,0,0,0,0,1.29901629313486
0,-1,1,0,0,3,3,9,8,8,8,9,9,3,4,3,1,24,0,0,1,0,0.709425618583655
-1,-1,-2,0,0,2,3,2,4,5,5,5,5,3,3,2,6,29,0,0,1,1,0.682345993448115
0,0,2,0,3,1,1,2,0,0,0,3,0,2,1,1,4,21,0,0,0,0,1.8898916982183
